( INST_cy_SPKR_diphone_0001	"sil @ xx p i p ay sil"	("p-i" "i-p") )
( INST_cy_SPKR_diphone_0002	"sil @ xx t i t ay sil"	("t-i" "i-t") )
( INST_cy_SPKR_diphone_0003	"sil @ xx k i k ay sil"	("k-i" "i-k") )
( INST_cy_SPKR_diphone_0004	"sil @ xx b i b ay sil"	("b-i" "i-b") )
( INST_cy_SPKR_diphone_0005	"sil @ xx d i d ay sil"	("d-i" "i-d") )
( INST_cy_SPKR_diphone_0006	"sil @ xx g i g ay sil"	("g-i" "i-g") )
( INST_cy_SPKR_diphone_0007	"sil @ xx f i f ay sil"	("f-i" "i-f") )
( INST_cy_SPKR_diphone_0008	"sil @ xx v i v ay sil"	("v-i" "i-v") )
( INST_cy_SPKR_diphone_0009	"sil @ xx th i th ay sil"	("th-i" "i-th") )
( INST_cy_SPKR_diphone_0010	"sil @ xx dh i dh ay sil"	("dh-i" "i-dh") )
( INST_cy_SPKR_diphone_0011	"sil @ xx s i s ay sil"	("s-i" "i-s") )
( INST_cy_SPKR_diphone_0012	"sil @ xx sh i sh ay sil"	("sh-i" "i-sh") )
( INST_cy_SPKR_diphone_0013	"sil @ xx r i r ay sil"	("r-i" "i-r") )
( INST_cy_SPKR_diphone_0014	"sil @ xx l i l ay sil"	("l-i" "i-l") )
( INST_cy_SPKR_diphone_0015	"sil @ xx m i m ay sil"	("m-i" "i-m") )
( INST_cy_SPKR_diphone_0016	"sil @ xx n i n ay sil"	("n-i" "i-n") )
( INST_cy_SPKR_diphone_0017	"sil @ xx ch i ch ay sil"	("ch-i" "i-ch") )
( INST_cy_SPKR_diphone_0018	"sil @ xx jh i jh ay sil"	("jh-i" "i-jh") )
( INST_cy_SPKR_diphone_0019	"sil @ xx lh i lh ay sil"	("lh-i" "i-lh") )
( INST_cy_SPKR_diphone_0020	"sil @ xx x i x ay sil"	("x-i" "i-x") )
( INST_cy_SPKR_diphone_0021	"sil @ xx hh i hh ay sil"	("hh-i" "i-hh") )
( INST_cy_SPKR_diphone_0022	"sil @ xx z i z ay sil"	("z-i" "i-z") )
( INST_cy_SPKR_diphone_0023	"sil @ xx p e p ay sil"	("p-e" "e-p") )
( INST_cy_SPKR_diphone_0024	"sil @ xx t e t ay sil"	("t-e" "e-t") )
( INST_cy_SPKR_diphone_0025	"sil @ xx k e k ay sil"	("k-e" "e-k") )
( INST_cy_SPKR_diphone_0026	"sil @ xx b e b ay sil"	("b-e" "e-b") )
( INST_cy_SPKR_diphone_0027	"sil @ xx d e d ay sil"	("d-e" "e-d") )
( INST_cy_SPKR_diphone_0028	"sil @ xx g e g ay sil"	("g-e" "e-g") )
( INST_cy_SPKR_diphone_0029	"sil @ xx f e f ay sil"	("f-e" "e-f") )
( INST_cy_SPKR_diphone_0030	"sil @ xx v e v ay sil"	("v-e" "e-v") )
( INST_cy_SPKR_diphone_0031	"sil @ xx th e th ay sil"	("th-e" "e-th") )
( INST_cy_SPKR_diphone_0032	"sil @ xx dh e dh ay sil"	("dh-e" "e-dh") )
( INST_cy_SPKR_diphone_0033	"sil @ xx s e s ay sil"	("s-e" "e-s") )
( INST_cy_SPKR_diphone_0034	"sil @ xx sh e sh ay sil"	("sh-e" "e-sh") )
( INST_cy_SPKR_diphone_0035	"sil @ xx r e r ay sil"	("r-e" "e-r") )
( INST_cy_SPKR_diphone_0036	"sil @ xx l e l ay sil"	("l-e" "e-l") )
( INST_cy_SPKR_diphone_0037	"sil @ xx m e m ay sil"	("m-e" "e-m") )
( INST_cy_SPKR_diphone_0038	"sil @ xx n e n ay sil"	("n-e" "e-n") )
( INST_cy_SPKR_diphone_0039	"sil @ xx ch e ch ay sil"	("ch-e" "e-ch") )
( INST_cy_SPKR_diphone_0040	"sil @ xx jh e jh ay sil"	("jh-e" "e-jh") )
( INST_cy_SPKR_diphone_0041	"sil @ xx lh e lh ay sil"	("lh-e" "e-lh") )
( INST_cy_SPKR_diphone_0042	"sil @ xx x e x ay sil"	("x-e" "e-x") )
( INST_cy_SPKR_diphone_0043	"sil @ xx hh e hh ay sil"	("hh-e" "e-hh") )
( INST_cy_SPKR_diphone_0044	"sil @ xx z e z ay sil"	("z-e" "e-z") )
( INST_cy_SPKR_diphone_0045	"sil @ xx p a p ay sil"	("p-a" "a-p") )
( INST_cy_SPKR_diphone_0046	"sil @ xx t a t ay sil"	("t-a" "a-t") )
( INST_cy_SPKR_diphone_0047	"sil @ xx k a k ay sil"	("k-a" "a-k") )
( INST_cy_SPKR_diphone_0048	"sil @ xx b a b ay sil"	("b-a" "a-b") )
( INST_cy_SPKR_diphone_0049	"sil @ xx d a d ay sil"	("d-a" "a-d") )
( INST_cy_SPKR_diphone_0050	"sil @ xx g a g ay sil"	("g-a" "a-g") )
( INST_cy_SPKR_diphone_0051	"sil @ xx f a f ay sil"	("f-a" "a-f") )
( INST_cy_SPKR_diphone_0052	"sil @ xx v a v ay sil"	("v-a" "a-v") )
( INST_cy_SPKR_diphone_0053	"sil @ xx th a th ay sil"	("th-a" "a-th") )
( INST_cy_SPKR_diphone_0054	"sil @ xx dh a dh ay sil"	("dh-a" "a-dh") )
( INST_cy_SPKR_diphone_0055	"sil @ xx s a s ay sil"	("s-a" "a-s") )
( INST_cy_SPKR_diphone_0056	"sil @ xx sh a sh ay sil"	("sh-a" "a-sh") )
( INST_cy_SPKR_diphone_0057	"sil @ xx r a r ay sil"	("r-a" "a-r") )
( INST_cy_SPKR_diphone_0058	"sil @ xx l a l ay sil"	("l-a" "a-l") )
( INST_cy_SPKR_diphone_0059	"sil @ xx m a m ay sil"	("m-a" "a-m") )
( INST_cy_SPKR_diphone_0060	"sil @ xx n a n ay sil"	("n-a" "a-n") )
( INST_cy_SPKR_diphone_0061	"sil @ xx ch a ch ay sil"	("ch-a" "a-ch") )
( INST_cy_SPKR_diphone_0062	"sil @ xx jh a jh ay sil"	("jh-a" "a-jh") )
( INST_cy_SPKR_diphone_0063	"sil @ xx lh a lh ay sil"	("lh-a" "a-lh") )
( INST_cy_SPKR_diphone_0064	"sil @ xx x a x ay sil"	("x-a" "a-x") )
( INST_cy_SPKR_diphone_0065	"sil @ xx hh a hh ay sil"	("hh-a" "a-hh") )
( INST_cy_SPKR_diphone_0066	"sil @ xx z a z ay sil"	("z-a" "a-z") )
( INST_cy_SPKR_diphone_0067	"sil @ xx p o p ay sil"	("p-o" "o-p") )
( INST_cy_SPKR_diphone_0068	"sil @ xx t o t ay sil"	("t-o" "o-t") )
( INST_cy_SPKR_diphone_0069	"sil @ xx k o k ay sil"	("k-o" "o-k") )
( INST_cy_SPKR_diphone_0070	"sil @ xx b o b ay sil"	("b-o" "o-b") )
( INST_cy_SPKR_diphone_0071	"sil @ xx d o d ay sil"	("d-o" "o-d") )
( INST_cy_SPKR_diphone_0072	"sil @ xx g o g ay sil"	("g-o" "o-g") )
( INST_cy_SPKR_diphone_0073	"sil @ xx f o f ay sil"	("f-o" "o-f") )
( INST_cy_SPKR_diphone_0074	"sil @ xx v o v ay sil"	("v-o" "o-v") )
( INST_cy_SPKR_diphone_0075	"sil @ xx th o th ay sil"	("th-o" "o-th") )
( INST_cy_SPKR_diphone_0076	"sil @ xx dh o dh ay sil"	("dh-o" "o-dh") )
( INST_cy_SPKR_diphone_0077	"sil @ xx s o s ay sil"	("s-o" "o-s") )
( INST_cy_SPKR_diphone_0078	"sil @ xx sh o sh ay sil"	("sh-o" "o-sh") )
( INST_cy_SPKR_diphone_0079	"sil @ xx r o r ay sil"	("r-o" "o-r") )
( INST_cy_SPKR_diphone_0080	"sil @ xx l o l ay sil"	("l-o" "o-l") )
( INST_cy_SPKR_diphone_0081	"sil @ xx m o m ay sil"	("m-o" "o-m") )
( INST_cy_SPKR_diphone_0082	"sil @ xx n o n ay sil"	("n-o" "o-n") )
( INST_cy_SPKR_diphone_0083	"sil @ xx ch o ch ay sil"	("ch-o" "o-ch") )
( INST_cy_SPKR_diphone_0084	"sil @ xx jh o jh ay sil"	("jh-o" "o-jh") )
( INST_cy_SPKR_diphone_0085	"sil @ xx lh o lh ay sil"	("lh-o" "o-lh") )
( INST_cy_SPKR_diphone_0086	"sil @ xx x o x ay sil"	("x-o" "o-x") )
( INST_cy_SPKR_diphone_0087	"sil @ xx hh o hh ay sil"	("hh-o" "o-hh") )
( INST_cy_SPKR_diphone_0088	"sil @ xx z o z ay sil"	("z-o" "o-z") )
( INST_cy_SPKR_diphone_0089	"sil @ xx p u p ay sil"	("p-u" "u-p") )
( INST_cy_SPKR_diphone_0090	"sil @ xx t u t ay sil"	("t-u" "u-t") )
( INST_cy_SPKR_diphone_0091	"sil @ xx k u k ay sil"	("k-u" "u-k") )
( INST_cy_SPKR_diphone_0092	"sil @ xx b u b ay sil"	("b-u" "u-b") )
( INST_cy_SPKR_diphone_0093	"sil @ xx d u d ay sil"	("d-u" "u-d") )
( INST_cy_SPKR_diphone_0094	"sil @ xx g u g ay sil"	("g-u" "u-g") )
( INST_cy_SPKR_diphone_0095	"sil @ xx f u f ay sil"	("f-u" "u-f") )
( INST_cy_SPKR_diphone_0096	"sil @ xx v u v ay sil"	("v-u" "u-v") )
( INST_cy_SPKR_diphone_0097	"sil @ xx th u th ay sil"	("th-u" "u-th") )
( INST_cy_SPKR_diphone_0098	"sil @ xx dh u dh ay sil"	("dh-u" "u-dh") )
( INST_cy_SPKR_diphone_0099	"sil @ xx s u s ay sil"	("s-u" "u-s") )
( INST_cy_SPKR_diphone_0100	"sil @ xx sh u sh ay sil"	("sh-u" "u-sh") )
( INST_cy_SPKR_diphone_0101	"sil @ xx r u r ay sil"	("r-u" "u-r") )
( INST_cy_SPKR_diphone_0102	"sil @ xx l u l ay sil"	("l-u" "u-l") )
( INST_cy_SPKR_diphone_0103	"sil @ xx m u m ay sil"	("m-u" "u-m") )
( INST_cy_SPKR_diphone_0104	"sil @ xx n u n ay sil"	("n-u" "u-n") )
( INST_cy_SPKR_diphone_0105	"sil @ xx ch u ch ay sil"	("ch-u" "u-ch") )
( INST_cy_SPKR_diphone_0106	"sil @ xx jh u jh ay sil"	("jh-u" "u-jh") )
( INST_cy_SPKR_diphone_0107	"sil @ xx lh u lh ay sil"	("lh-u" "u-lh") )
( INST_cy_SPKR_diphone_0108	"sil @ xx x u x ay sil"	("x-u" "u-x") )
( INST_cy_SPKR_diphone_0109	"sil @ xx hh u hh ay sil"	("hh-u" "u-hh") )
( INST_cy_SPKR_diphone_0110	"sil @ xx z u z ay sil"	("z-u" "u-z") )
( INST_cy_SPKR_diphone_0111	"sil @ xx p y p ay sil"	("p-y" "y-p") )
( INST_cy_SPKR_diphone_0112	"sil @ xx t y t ay sil"	("t-y" "y-t") )
( INST_cy_SPKR_diphone_0113	"sil @ xx k y k ay sil"	("k-y" "y-k") )
( INST_cy_SPKR_diphone_0114	"sil @ xx b y b ay sil"	("b-y" "y-b") )
( INST_cy_SPKR_diphone_0115	"sil @ xx d y d ay sil"	("d-y" "y-d") )
( INST_cy_SPKR_diphone_0116	"sil @ xx g y g ay sil"	("g-y" "y-g") )
( INST_cy_SPKR_diphone_0117	"sil @ xx f y f ay sil"	("f-y" "y-f") )
( INST_cy_SPKR_diphone_0118	"sil @ xx v y v ay sil"	("v-y" "y-v") )
( INST_cy_SPKR_diphone_0119	"sil @ xx th y th ay sil"	("th-y" "y-th") )
( INST_cy_SPKR_diphone_0120	"sil @ xx dh y dh ay sil"	("dh-y" "y-dh") )
( INST_cy_SPKR_diphone_0121	"sil @ xx s y s ay sil"	("s-y" "y-s") )
( INST_cy_SPKR_diphone_0122	"sil @ xx sh y sh ay sil"	("sh-y" "y-sh") )
( INST_cy_SPKR_diphone_0123	"sil @ xx r y r ay sil"	("r-y" "y-r") )
( INST_cy_SPKR_diphone_0124	"sil @ xx l y l ay sil"	("l-y" "y-l") )
( INST_cy_SPKR_diphone_0125	"sil @ xx m y m ay sil"	("m-y" "y-m") )
( INST_cy_SPKR_diphone_0126	"sil @ xx n y n ay sil"	("n-y" "y-n") )
( INST_cy_SPKR_diphone_0127	"sil @ xx ch y ch ay sil"	("ch-y" "y-ch") )
( INST_cy_SPKR_diphone_0128	"sil @ xx jh y jh ay sil"	("jh-y" "y-jh") )
( INST_cy_SPKR_diphone_0129	"sil @ xx lh y lh ay sil"	("lh-y" "y-lh") )
( INST_cy_SPKR_diphone_0130	"sil @ xx x y x ay sil"	("x-y" "y-x") )
( INST_cy_SPKR_diphone_0131	"sil @ xx hh y hh ay sil"	("hh-y" "y-hh") )
( INST_cy_SPKR_diphone_0132	"sil @ xx z y z ay sil"	("z-y" "y-z") )
( INST_cy_SPKR_diphone_0133	"sil @ xx p @ p ay sil"	("p-@" "@-p") )
( INST_cy_SPKR_diphone_0134	"sil @ xx t @ t ay sil"	("t-@" "@-t") )
( INST_cy_SPKR_diphone_0135	"sil @ xx k @ k ay sil"	("k-@" "@-k") )
( INST_cy_SPKR_diphone_0136	"sil @ xx b @ b ay sil"	("b-@" "@-b") )
( INST_cy_SPKR_diphone_0137	"sil @ xx d @ d ay sil"	("d-@" "@-d") )
( INST_cy_SPKR_diphone_0138	"sil @ xx g @ g ay sil"	("g-@" "@-g") )
( INST_cy_SPKR_diphone_0139	"sil @ xx f @ f ay sil"	("f-@" "@-f") )
( INST_cy_SPKR_diphone_0140	"sil @ xx v @ v ay sil"	("v-@" "@-v") )
( INST_cy_SPKR_diphone_0141	"sil @ xx th @ th ay sil"	("th-@" "@-th") )
( INST_cy_SPKR_diphone_0142	"sil @ xx dh @ dh ay sil"	("dh-@" "@-dh") )
( INST_cy_SPKR_diphone_0143	"sil @ xx s @ s ay sil"	("s-@" "@-s") )
( INST_cy_SPKR_diphone_0144	"sil @ xx sh @ sh ay sil"	("sh-@" "@-sh") )
( INST_cy_SPKR_diphone_0145	"sil @ xx r @ r ay sil"	("r-@" "@-r") )
( INST_cy_SPKR_diphone_0146	"sil @ xx l @ l ay sil"	("l-@" "@-l") )
( INST_cy_SPKR_diphone_0147	"sil @ xx m @ m ay sil"	("m-@" "@-m") )
( INST_cy_SPKR_diphone_0148	"sil @ xx n @ n ay sil"	("n-@" "@-n") )
( INST_cy_SPKR_diphone_0149	"sil @ xx ch @ ch ay sil"	("ch-@" "@-ch") )
( INST_cy_SPKR_diphone_0150	"sil @ xx jh @ jh ay sil"	("jh-@" "@-jh") )
( INST_cy_SPKR_diphone_0151	"sil @ xx lh @ lh ay sil"	("lh-@" "@-lh") )
( INST_cy_SPKR_diphone_0152	"sil @ xx x @ x ay sil"	("x-@" "@-x") )
( INST_cy_SPKR_diphone_0153	"sil @ xx hh @ hh ay sil"	("hh-@" "@-hh") )
( INST_cy_SPKR_diphone_0154	"sil @ xx z @ z ay sil"	("z-@" "@-z") )
( INST_cy_SPKR_diphone_0155	"sil @ xx p ii p ay sil"	("p-ii" "ii-p") )
( INST_cy_SPKR_diphone_0156	"sil @ xx t ii t ay sil"	("t-ii" "ii-t") )
( INST_cy_SPKR_diphone_0157	"sil @ xx k ii k ay sil"	("k-ii" "ii-k") )
( INST_cy_SPKR_diphone_0158	"sil @ xx b ii b ay sil"	("b-ii" "ii-b") )
( INST_cy_SPKR_diphone_0159	"sil @ xx d ii d ay sil"	("d-ii" "ii-d") )
( INST_cy_SPKR_diphone_0160	"sil @ xx g ii g ay sil"	("g-ii" "ii-g") )
( INST_cy_SPKR_diphone_0161	"sil @ xx f ii f ay sil"	("f-ii" "ii-f") )
( INST_cy_SPKR_diphone_0162	"sil @ xx v ii v ay sil"	("v-ii" "ii-v") )
( INST_cy_SPKR_diphone_0163	"sil @ xx th ii th ay sil"	("th-ii" "ii-th") )
( INST_cy_SPKR_diphone_0164	"sil @ xx dh ii dh ay sil"	("dh-ii" "ii-dh") )
( INST_cy_SPKR_diphone_0165	"sil @ xx s ii s ay sil"	("s-ii" "ii-s") )
( INST_cy_SPKR_diphone_0166	"sil @ xx sh ii sh ay sil"	("sh-ii" "ii-sh") )
( INST_cy_SPKR_diphone_0167	"sil @ xx r ii r ay sil"	("r-ii" "ii-r") )
( INST_cy_SPKR_diphone_0168	"sil @ xx l ii l ay sil"	("l-ii" "ii-l") )
( INST_cy_SPKR_diphone_0169	"sil @ xx m ii m ay sil"	("m-ii" "ii-m") )
( INST_cy_SPKR_diphone_0170	"sil @ xx n ii n ay sil"	("n-ii" "ii-n") )
( INST_cy_SPKR_diphone_0171	"sil @ xx ch ii ch ay sil"	("ch-ii" "ii-ch") )
( INST_cy_SPKR_diphone_0172	"sil @ xx jh ii jh ay sil"	("jh-ii" "ii-jh") )
( INST_cy_SPKR_diphone_0173	"sil @ xx lh ii lh ay sil"	("lh-ii" "ii-lh") )
( INST_cy_SPKR_diphone_0174	"sil @ xx x ii x ay sil"	("x-ii" "ii-x") )
( INST_cy_SPKR_diphone_0175	"sil @ xx hh ii hh ay sil"	("hh-ii" "ii-hh") )
( INST_cy_SPKR_diphone_0176	"sil @ xx z ii z ay sil"	("z-ii" "ii-z") )
( INST_cy_SPKR_diphone_0177	"sil @ xx p ee p ay sil"	("p-ee" "ee-p") )
( INST_cy_SPKR_diphone_0178	"sil @ xx t ee t ay sil"	("t-ee" "ee-t") )
( INST_cy_SPKR_diphone_0179	"sil @ xx k ee k ay sil"	("k-ee" "ee-k") )
( INST_cy_SPKR_diphone_0180	"sil @ xx b ee b ay sil"	("b-ee" "ee-b") )
( INST_cy_SPKR_diphone_0181	"sil @ xx d ee d ay sil"	("d-ee" "ee-d") )
( INST_cy_SPKR_diphone_0182	"sil @ xx g ee g ay sil"	("g-ee" "ee-g") )
( INST_cy_SPKR_diphone_0183	"sil @ xx f ee f ay sil"	("f-ee" "ee-f") )
( INST_cy_SPKR_diphone_0184	"sil @ xx v ee v ay sil"	("v-ee" "ee-v") )
( INST_cy_SPKR_diphone_0185	"sil @ xx th ee th ay sil"	("th-ee" "ee-th") )
( INST_cy_SPKR_diphone_0186	"sil @ xx dh ee dh ay sil"	("dh-ee" "ee-dh") )
( INST_cy_SPKR_diphone_0187	"sil @ xx s ee s ay sil"	("s-ee" "ee-s") )
( INST_cy_SPKR_diphone_0188	"sil @ xx sh ee sh ay sil"	("sh-ee" "ee-sh") )
( INST_cy_SPKR_diphone_0189	"sil @ xx r ee r ay sil"	("r-ee" "ee-r") )
( INST_cy_SPKR_diphone_0190	"sil @ xx l ee l ay sil"	("l-ee" "ee-l") )
( INST_cy_SPKR_diphone_0191	"sil @ xx m ee m ay sil"	("m-ee" "ee-m") )
( INST_cy_SPKR_diphone_0192	"sil @ xx n ee n ay sil"	("n-ee" "ee-n") )
( INST_cy_SPKR_diphone_0193	"sil @ xx ch ee ch ay sil"	("ch-ee" "ee-ch") )
( INST_cy_SPKR_diphone_0194	"sil @ xx jh ee jh ay sil"	("jh-ee" "ee-jh") )
( INST_cy_SPKR_diphone_0195	"sil @ xx lh ee lh ay sil"	("lh-ee" "ee-lh") )
( INST_cy_SPKR_diphone_0196	"sil @ xx x ee x ay sil"	("x-ee" "ee-x") )
( INST_cy_SPKR_diphone_0197	"sil @ xx hh ee hh ay sil"	("hh-ee" "ee-hh") )
( INST_cy_SPKR_diphone_0198	"sil @ xx z ee z ay sil"	("z-ee" "ee-z") )
( INST_cy_SPKR_diphone_0199	"sil @ xx p aa p ay sil"	("p-aa" "aa-p") )
( INST_cy_SPKR_diphone_0200	"sil @ xx t aa t ay sil"	("t-aa" "aa-t") )
( INST_cy_SPKR_diphone_0201	"sil @ xx k aa k ay sil"	("k-aa" "aa-k") )
( INST_cy_SPKR_diphone_0202	"sil @ xx b aa b ay sil"	("b-aa" "aa-b") )
( INST_cy_SPKR_diphone_0203	"sil @ xx d aa d ay sil"	("d-aa" "aa-d") )
( INST_cy_SPKR_diphone_0204	"sil @ xx g aa g ay sil"	("g-aa" "aa-g") )
( INST_cy_SPKR_diphone_0205	"sil @ xx f aa f ay sil"	("f-aa" "aa-f") )
( INST_cy_SPKR_diphone_0206	"sil @ xx v aa v ay sil"	("v-aa" "aa-v") )
( INST_cy_SPKR_diphone_0207	"sil @ xx th aa th ay sil"	("th-aa" "aa-th") )
( INST_cy_SPKR_diphone_0208	"sil @ xx dh aa dh ay sil"	("dh-aa" "aa-dh") )
( INST_cy_SPKR_diphone_0209	"sil @ xx s aa s ay sil"	("s-aa" "aa-s") )
( INST_cy_SPKR_diphone_0210	"sil @ xx sh aa sh ay sil"	("sh-aa" "aa-sh") )
( INST_cy_SPKR_diphone_0211	"sil @ xx r aa r ay sil"	("r-aa" "aa-r") )
( INST_cy_SPKR_diphone_0212	"sil @ xx l aa l ay sil"	("l-aa" "aa-l") )
( INST_cy_SPKR_diphone_0213	"sil @ xx m aa m ay sil"	("m-aa" "aa-m") )
( INST_cy_SPKR_diphone_0214	"sil @ xx n aa n ay sil"	("n-aa" "aa-n") )
( INST_cy_SPKR_diphone_0215	"sil @ xx ch aa ch ay sil"	("ch-aa" "aa-ch") )
( INST_cy_SPKR_diphone_0216	"sil @ xx jh aa jh ay sil"	("jh-aa" "aa-jh") )
( INST_cy_SPKR_diphone_0217	"sil @ xx lh aa lh ay sil"	("lh-aa" "aa-lh") )
( INST_cy_SPKR_diphone_0218	"sil @ xx x aa x ay sil"	("x-aa" "aa-x") )
( INST_cy_SPKR_diphone_0219	"sil @ xx hh aa hh ay sil"	("hh-aa" "aa-hh") )
( INST_cy_SPKR_diphone_0220	"sil @ xx z aa z ay sil"	("z-aa" "aa-z") )
( INST_cy_SPKR_diphone_0221	"sil @ xx p oo p ay sil"	("p-oo" "oo-p") )
( INST_cy_SPKR_diphone_0222	"sil @ xx t oo t ay sil"	("t-oo" "oo-t") )
( INST_cy_SPKR_diphone_0223	"sil @ xx k oo k ay sil"	("k-oo" "oo-k") )
( INST_cy_SPKR_diphone_0224	"sil @ xx b oo b ay sil"	("b-oo" "oo-b") )
( INST_cy_SPKR_diphone_0225	"sil @ xx d oo d ay sil"	("d-oo" "oo-d") )
( INST_cy_SPKR_diphone_0226	"sil @ xx g oo g ay sil"	("g-oo" "oo-g") )
( INST_cy_SPKR_diphone_0227	"sil @ xx f oo f ay sil"	("f-oo" "oo-f") )
( INST_cy_SPKR_diphone_0228	"sil @ xx v oo v ay sil"	("v-oo" "oo-v") )
( INST_cy_SPKR_diphone_0229	"sil @ xx th oo th ay sil"	("th-oo" "oo-th") )
( INST_cy_SPKR_diphone_0230	"sil @ xx dh oo dh ay sil"	("dh-oo" "oo-dh") )
( INST_cy_SPKR_diphone_0231	"sil @ xx s oo s ay sil"	("s-oo" "oo-s") )
( INST_cy_SPKR_diphone_0232	"sil @ xx sh oo sh ay sil"	("sh-oo" "oo-sh") )
( INST_cy_SPKR_diphone_0233	"sil @ xx r oo r ay sil"	("r-oo" "oo-r") )
( INST_cy_SPKR_diphone_0234	"sil @ xx l oo l ay sil"	("l-oo" "oo-l") )
( INST_cy_SPKR_diphone_0235	"sil @ xx m oo m ay sil"	("m-oo" "oo-m") )
( INST_cy_SPKR_diphone_0236	"sil @ xx n oo n ay sil"	("n-oo" "oo-n") )
( INST_cy_SPKR_diphone_0237	"sil @ xx ch oo ch ay sil"	("ch-oo" "oo-ch") )
( INST_cy_SPKR_diphone_0238	"sil @ xx jh oo jh ay sil"	("jh-oo" "oo-jh") )
( INST_cy_SPKR_diphone_0239	"sil @ xx lh oo lh ay sil"	("lh-oo" "oo-lh") )
( INST_cy_SPKR_diphone_0240	"sil @ xx x oo x ay sil"	("x-oo" "oo-x") )
( INST_cy_SPKR_diphone_0241	"sil @ xx hh oo hh ay sil"	("hh-oo" "oo-hh") )
( INST_cy_SPKR_diphone_0242	"sil @ xx z oo z ay sil"	("z-oo" "oo-z") )
( INST_cy_SPKR_diphone_0243	"sil @ xx p uu p ay sil"	("p-uu" "uu-p") )
( INST_cy_SPKR_diphone_0244	"sil @ xx t uu t ay sil"	("t-uu" "uu-t") )
( INST_cy_SPKR_diphone_0245	"sil @ xx k uu k ay sil"	("k-uu" "uu-k") )
( INST_cy_SPKR_diphone_0246	"sil @ xx b uu b ay sil"	("b-uu" "uu-b") )
( INST_cy_SPKR_diphone_0247	"sil @ xx d uu d ay sil"	("d-uu" "uu-d") )
( INST_cy_SPKR_diphone_0248	"sil @ xx g uu g ay sil"	("g-uu" "uu-g") )
( INST_cy_SPKR_diphone_0249	"sil @ xx f uu f ay sil"	("f-uu" "uu-f") )
( INST_cy_SPKR_diphone_0250	"sil @ xx v uu v ay sil"	("v-uu" "uu-v") )
( INST_cy_SPKR_diphone_0251	"sil @ xx th uu th ay sil"	("th-uu" "uu-th") )
( INST_cy_SPKR_diphone_0252	"sil @ xx dh uu dh ay sil"	("dh-uu" "uu-dh") )
( INST_cy_SPKR_diphone_0253	"sil @ xx s uu s ay sil"	("s-uu" "uu-s") )
( INST_cy_SPKR_diphone_0254	"sil @ xx sh uu sh ay sil"	("sh-uu" "uu-sh") )
( INST_cy_SPKR_diphone_0255	"sil @ xx r uu r ay sil"	("r-uu" "uu-r") )
( INST_cy_SPKR_diphone_0256	"sil @ xx l uu l ay sil"	("l-uu" "uu-l") )
( INST_cy_SPKR_diphone_0257	"sil @ xx m uu m ay sil"	("m-uu" "uu-m") )
( INST_cy_SPKR_diphone_0258	"sil @ xx n uu n ay sil"	("n-uu" "uu-n") )
( INST_cy_SPKR_diphone_0259	"sil @ xx ch uu ch ay sil"	("ch-uu" "uu-ch") )
( INST_cy_SPKR_diphone_0260	"sil @ xx jh uu jh ay sil"	("jh-uu" "uu-jh") )
( INST_cy_SPKR_diphone_0261	"sil @ xx lh uu lh ay sil"	("lh-uu" "uu-lh") )
( INST_cy_SPKR_diphone_0262	"sil @ xx x uu x ay sil"	("x-uu" "uu-x") )
( INST_cy_SPKR_diphone_0263	"sil @ xx hh uu hh ay sil"	("hh-uu" "uu-hh") )
( INST_cy_SPKR_diphone_0264	"sil @ xx z uu z ay sil"	("z-uu" "uu-z") )
( INST_cy_SPKR_diphone_0265	"sil @ xx p yy p ay sil"	("p-yy" "yy-p") )
( INST_cy_SPKR_diphone_0266	"sil @ xx t yy t ay sil"	("t-yy" "yy-t") )
( INST_cy_SPKR_diphone_0267	"sil @ xx k yy k ay sil"	("k-yy" "yy-k") )
( INST_cy_SPKR_diphone_0268	"sil @ xx b yy b ay sil"	("b-yy" "yy-b") )
( INST_cy_SPKR_diphone_0269	"sil @ xx d yy d ay sil"	("d-yy" "yy-d") )
( INST_cy_SPKR_diphone_0270	"sil @ xx g yy g ay sil"	("g-yy" "yy-g") )
( INST_cy_SPKR_diphone_0271	"sil @ xx f yy f ay sil"	("f-yy" "yy-f") )
( INST_cy_SPKR_diphone_0272	"sil @ xx v yy v ay sil"	("v-yy" "yy-v") )
( INST_cy_SPKR_diphone_0273	"sil @ xx th yy th ay sil"	("th-yy" "yy-th") )
( INST_cy_SPKR_diphone_0274	"sil @ xx dh yy dh ay sil"	("dh-yy" "yy-dh") )
( INST_cy_SPKR_diphone_0275	"sil @ xx s yy s ay sil"	("s-yy" "yy-s") )
( INST_cy_SPKR_diphone_0276	"sil @ xx sh yy sh ay sil"	("sh-yy" "yy-sh") )
( INST_cy_SPKR_diphone_0277	"sil @ xx r yy r ay sil"	("r-yy" "yy-r") )
( INST_cy_SPKR_diphone_0278	"sil @ xx l yy l ay sil"	("l-yy" "yy-l") )
( INST_cy_SPKR_diphone_0279	"sil @ xx m yy m ay sil"	("m-yy" "yy-m") )
( INST_cy_SPKR_diphone_0280	"sil @ xx n yy n ay sil"	("n-yy" "yy-n") )
( INST_cy_SPKR_diphone_0281	"sil @ xx ch yy ch ay sil"	("ch-yy" "yy-ch") )
( INST_cy_SPKR_diphone_0282	"sil @ xx jh yy jh ay sil"	("jh-yy" "yy-jh") )
( INST_cy_SPKR_diphone_0283	"sil @ xx lh yy lh ay sil"	("lh-yy" "yy-lh") )
( INST_cy_SPKR_diphone_0284	"sil @ xx x yy x ay sil"	("x-yy" "yy-x") )
( INST_cy_SPKR_diphone_0285	"sil @ xx hh yy hh ay sil"	("hh-yy" "yy-hh") )
( INST_cy_SPKR_diphone_0286	"sil @ xx z yy z ay sil"	("z-yy" "yy-z") )
( INST_cy_SPKR_diphone_0287	"sil @ xx p ei p ay sil"	("p-ei" "ei-p") )
( INST_cy_SPKR_diphone_0288	"sil @ xx t ei t ay sil"	("t-ei" "ei-t") )
( INST_cy_SPKR_diphone_0289	"sil @ xx k ei k ay sil"	("k-ei" "ei-k") )
( INST_cy_SPKR_diphone_0290	"sil @ xx b ei b ay sil"	("b-ei" "ei-b") )
( INST_cy_SPKR_diphone_0291	"sil @ xx d ei d ay sil"	("d-ei" "ei-d") )
( INST_cy_SPKR_diphone_0292	"sil @ xx g ei g ay sil"	("g-ei" "ei-g") )
( INST_cy_SPKR_diphone_0293	"sil @ xx f ei f ay sil"	("f-ei" "ei-f") )
( INST_cy_SPKR_diphone_0294	"sil @ xx v ei v ay sil"	("v-ei" "ei-v") )
( INST_cy_SPKR_diphone_0295	"sil @ xx th ei th ay sil"	("th-ei" "ei-th") )
( INST_cy_SPKR_diphone_0296	"sil @ xx dh ei dh ay sil"	("dh-ei" "ei-dh") )
( INST_cy_SPKR_diphone_0297	"sil @ xx s ei s ay sil"	("s-ei" "ei-s") )
( INST_cy_SPKR_diphone_0298	"sil @ xx sh ei sh ay sil"	("sh-ei" "ei-sh") )
( INST_cy_SPKR_diphone_0299	"sil @ xx r ei r ay sil"	("r-ei" "ei-r") )
( INST_cy_SPKR_diphone_0300	"sil @ xx l ei l ay sil"	("l-ei" "ei-l") )
( INST_cy_SPKR_diphone_0301	"sil @ xx m ei m ay sil"	("m-ei" "ei-m") )
( INST_cy_SPKR_diphone_0302	"sil @ xx n ei n ay sil"	("n-ei" "ei-n") )
( INST_cy_SPKR_diphone_0303	"sil @ xx ch ei ch ay sil"	("ch-ei" "ei-ch") )
( INST_cy_SPKR_diphone_0304	"sil @ xx jh ei jh ay sil"	("jh-ei" "ei-jh") )
( INST_cy_SPKR_diphone_0305	"sil @ xx lh ei lh ay sil"	("lh-ei" "ei-lh") )
( INST_cy_SPKR_diphone_0306	"sil @ xx x ei x ay sil"	("x-ei" "ei-x") )
( INST_cy_SPKR_diphone_0307	"sil @ xx hh ei hh ay sil"	("hh-ei" "ei-hh") )
( INST_cy_SPKR_diphone_0308	"sil @ xx z ei z ay sil"	("z-ei" "ei-z") )
( INST_cy_SPKR_diphone_0309	"sil @ xx p ai p ay sil"	("p-ai" "ai-p") )
( INST_cy_SPKR_diphone_0310	"sil @ xx t ai t ay sil"	("t-ai" "ai-t") )
( INST_cy_SPKR_diphone_0311	"sil @ xx k ai k ay sil"	("k-ai" "ai-k") )
( INST_cy_SPKR_diphone_0312	"sil @ xx b ai b ay sil"	("b-ai" "ai-b") )
( INST_cy_SPKR_diphone_0313	"sil @ xx d ai d ay sil"	("d-ai" "ai-d") )
( INST_cy_SPKR_diphone_0314	"sil @ xx g ai g ay sil"	("g-ai" "ai-g") )
( INST_cy_SPKR_diphone_0315	"sil @ xx f ai f ay sil"	("f-ai" "ai-f") )
( INST_cy_SPKR_diphone_0316	"sil @ xx v ai v ay sil"	("v-ai" "ai-v") )
( INST_cy_SPKR_diphone_0317	"sil @ xx th ai th ay sil"	("th-ai" "ai-th") )
( INST_cy_SPKR_diphone_0318	"sil @ xx dh ai dh ay sil"	("dh-ai" "ai-dh") )
( INST_cy_SPKR_diphone_0319	"sil @ xx s ai s ay sil"	("s-ai" "ai-s") )
( INST_cy_SPKR_diphone_0320	"sil @ xx sh ai sh ay sil"	("sh-ai" "ai-sh") )
( INST_cy_SPKR_diphone_0321	"sil @ xx r ai r ay sil"	("r-ai" "ai-r") )
( INST_cy_SPKR_diphone_0322	"sil @ xx l ai l ay sil"	("l-ai" "ai-l") )
( INST_cy_SPKR_diphone_0323	"sil @ xx m ai m ay sil"	("m-ai" "ai-m") )
( INST_cy_SPKR_diphone_0324	"sil @ xx n ai n ay sil"	("n-ai" "ai-n") )
( INST_cy_SPKR_diphone_0325	"sil @ xx ch ai ch ay sil"	("ch-ai" "ai-ch") )
( INST_cy_SPKR_diphone_0326	"sil @ xx jh ai jh ay sil"	("jh-ai" "ai-jh") )
( INST_cy_SPKR_diphone_0327	"sil @ xx lh ai lh ay sil"	("lh-ai" "ai-lh") )
( INST_cy_SPKR_diphone_0328	"sil @ xx x ai x ay sil"	("x-ai" "ai-x") )
( INST_cy_SPKR_diphone_0329	"sil @ xx hh ai hh ay sil"	("hh-ai" "ai-hh") )
( INST_cy_SPKR_diphone_0330	"sil @ xx z ai z ay sil"	("z-ai" "ai-z") )
( INST_cy_SPKR_diphone_0331	"sil @ xx p oi p ay sil"	("p-oi" "oi-p") )
( INST_cy_SPKR_diphone_0332	"sil @ xx t oi t ay sil"	("t-oi" "oi-t") )
( INST_cy_SPKR_diphone_0333	"sil @ xx k oi k ay sil"	("k-oi" "oi-k") )
( INST_cy_SPKR_diphone_0334	"sil @ xx b oi b ay sil"	("b-oi" "oi-b") )
( INST_cy_SPKR_diphone_0335	"sil @ xx d oi d ay sil"	("d-oi" "oi-d") )
( INST_cy_SPKR_diphone_0336	"sil @ xx g oi g ay sil"	("g-oi" "oi-g") )
( INST_cy_SPKR_diphone_0337	"sil @ xx f oi f ay sil"	("f-oi" "oi-f") )
( INST_cy_SPKR_diphone_0338	"sil @ xx v oi v ay sil"	("v-oi" "oi-v") )
( INST_cy_SPKR_diphone_0339	"sil @ xx th oi th ay sil"	("th-oi" "oi-th") )
( INST_cy_SPKR_diphone_0340	"sil @ xx dh oi dh ay sil"	("dh-oi" "oi-dh") )
( INST_cy_SPKR_diphone_0341	"sil @ xx s oi s ay sil"	("s-oi" "oi-s") )
( INST_cy_SPKR_diphone_0342	"sil @ xx sh oi sh ay sil"	("sh-oi" "oi-sh") )
( INST_cy_SPKR_diphone_0343	"sil @ xx r oi r ay sil"	("r-oi" "oi-r") )
( INST_cy_SPKR_diphone_0344	"sil @ xx l oi l ay sil"	("l-oi" "oi-l") )
( INST_cy_SPKR_diphone_0345	"sil @ xx m oi m ay sil"	("m-oi" "oi-m") )
( INST_cy_SPKR_diphone_0346	"sil @ xx n oi n ay sil"	("n-oi" "oi-n") )
( INST_cy_SPKR_diphone_0347	"sil @ xx ch oi ch ay sil"	("ch-oi" "oi-ch") )
( INST_cy_SPKR_diphone_0348	"sil @ xx jh oi jh ay sil"	("jh-oi" "oi-jh") )
( INST_cy_SPKR_diphone_0349	"sil @ xx lh oi lh ay sil"	("lh-oi" "oi-lh") )
( INST_cy_SPKR_diphone_0350	"sil @ xx x oi x ay sil"	("x-oi" "oi-x") )
( INST_cy_SPKR_diphone_0351	"sil @ xx hh oi hh ay sil"	("hh-oi" "oi-hh") )
( INST_cy_SPKR_diphone_0352	"sil @ xx z oi z ay sil"	("z-oi" "oi-z") )
( INST_cy_SPKR_diphone_0353	"sil @ xx p iu p ay sil"	("p-iu" "iu-p") )
( INST_cy_SPKR_diphone_0354	"sil @ xx t iu t ay sil"	("t-iu" "iu-t") )
( INST_cy_SPKR_diphone_0355	"sil @ xx k iu k ay sil"	("k-iu" "iu-k") )
( INST_cy_SPKR_diphone_0356	"sil @ xx b iu b ay sil"	("b-iu" "iu-b") )
( INST_cy_SPKR_diphone_0357	"sil @ xx d iu d ay sil"	("d-iu" "iu-d") )
( INST_cy_SPKR_diphone_0358	"sil @ xx g iu g ay sil"	("g-iu" "iu-g") )
( INST_cy_SPKR_diphone_0359	"sil @ xx f iu f ay sil"	("f-iu" "iu-f") )
( INST_cy_SPKR_diphone_0360	"sil @ xx v iu v ay sil"	("v-iu" "iu-v") )
( INST_cy_SPKR_diphone_0361	"sil @ xx th iu th ay sil"	("th-iu" "iu-th") )
( INST_cy_SPKR_diphone_0362	"sil @ xx dh iu dh ay sil"	("dh-iu" "iu-dh") )
( INST_cy_SPKR_diphone_0363	"sil @ xx s iu s ay sil"	("s-iu" "iu-s") )
( INST_cy_SPKR_diphone_0364	"sil @ xx sh iu sh ay sil"	("sh-iu" "iu-sh") )
( INST_cy_SPKR_diphone_0365	"sil @ xx r iu r ay sil"	("r-iu" "iu-r") )
( INST_cy_SPKR_diphone_0366	"sil @ xx l iu l ay sil"	("l-iu" "iu-l") )
( INST_cy_SPKR_diphone_0367	"sil @ xx m iu m ay sil"	("m-iu" "iu-m") )
( INST_cy_SPKR_diphone_0368	"sil @ xx n iu n ay sil"	("n-iu" "iu-n") )
( INST_cy_SPKR_diphone_0369	"sil @ xx ch iu ch ay sil"	("ch-iu" "iu-ch") )
( INST_cy_SPKR_diphone_0370	"sil @ xx jh iu jh ay sil"	("jh-iu" "iu-jh") )
( INST_cy_SPKR_diphone_0371	"sil @ xx lh iu lh ay sil"	("lh-iu" "iu-lh") )
( INST_cy_SPKR_diphone_0372	"sil @ xx x iu x ay sil"	("x-iu" "iu-x") )
( INST_cy_SPKR_diphone_0373	"sil @ xx hh iu hh ay sil"	("hh-iu" "iu-hh") )
( INST_cy_SPKR_diphone_0374	"sil @ xx z iu z ay sil"	("z-iu" "iu-z") )
( INST_cy_SPKR_diphone_0375	"sil @ xx p eu p ay sil"	("p-eu" "eu-p") )
( INST_cy_SPKR_diphone_0376	"sil @ xx t eu t ay sil"	("t-eu" "eu-t") )
( INST_cy_SPKR_diphone_0377	"sil @ xx k eu k ay sil"	("k-eu" "eu-k") )
( INST_cy_SPKR_diphone_0378	"sil @ xx b eu b ay sil"	("b-eu" "eu-b") )
( INST_cy_SPKR_diphone_0379	"sil @ xx d eu d ay sil"	("d-eu" "eu-d") )
( INST_cy_SPKR_diphone_0380	"sil @ xx g eu g ay sil"	("g-eu" "eu-g") )
( INST_cy_SPKR_diphone_0381	"sil @ xx f eu f ay sil"	("f-eu" "eu-f") )
( INST_cy_SPKR_diphone_0382	"sil @ xx v eu v ay sil"	("v-eu" "eu-v") )
( INST_cy_SPKR_diphone_0383	"sil @ xx th eu th ay sil"	("th-eu" "eu-th") )
( INST_cy_SPKR_diphone_0384	"sil @ xx dh eu dh ay sil"	("dh-eu" "eu-dh") )
( INST_cy_SPKR_diphone_0385	"sil @ xx s eu s ay sil"	("s-eu" "eu-s") )
( INST_cy_SPKR_diphone_0386	"sil @ xx sh eu sh ay sil"	("sh-eu" "eu-sh") )
( INST_cy_SPKR_diphone_0387	"sil @ xx r eu r ay sil"	("r-eu" "eu-r") )
( INST_cy_SPKR_diphone_0388	"sil @ xx l eu l ay sil"	("l-eu" "eu-l") )
( INST_cy_SPKR_diphone_0389	"sil @ xx m eu m ay sil"	("m-eu" "eu-m") )
( INST_cy_SPKR_diphone_0390	"sil @ xx n eu n ay sil"	("n-eu" "eu-n") )
( INST_cy_SPKR_diphone_0391	"sil @ xx ch eu ch ay sil"	("ch-eu" "eu-ch") )
( INST_cy_SPKR_diphone_0392	"sil @ xx jh eu jh ay sil"	("jh-eu" "eu-jh") )
( INST_cy_SPKR_diphone_0393	"sil @ xx lh eu lh ay sil"	("lh-eu" "eu-lh") )
( INST_cy_SPKR_diphone_0394	"sil @ xx x eu x ay sil"	("x-eu" "eu-x") )
( INST_cy_SPKR_diphone_0395	"sil @ xx hh eu hh ay sil"	("hh-eu" "eu-hh") )
( INST_cy_SPKR_diphone_0396	"sil @ xx z eu z ay sil"	("z-eu" "eu-z") )
( INST_cy_SPKR_diphone_0397	"sil @ xx p au p ay sil"	("p-au" "au-p") )
( INST_cy_SPKR_diphone_0398	"sil @ xx t au t ay sil"	("t-au" "au-t") )
( INST_cy_SPKR_diphone_0399	"sil @ xx k au k ay sil"	("k-au" "au-k") )
( INST_cy_SPKR_diphone_0400	"sil @ xx b au b ay sil"	("b-au" "au-b") )
( INST_cy_SPKR_diphone_0401	"sil @ xx d au d ay sil"	("d-au" "au-d") )
( INST_cy_SPKR_diphone_0402	"sil @ xx g au g ay sil"	("g-au" "au-g") )
( INST_cy_SPKR_diphone_0403	"sil @ xx f au f ay sil"	("f-au" "au-f") )
( INST_cy_SPKR_diphone_0404	"sil @ xx v au v ay sil"	("v-au" "au-v") )
( INST_cy_SPKR_diphone_0405	"sil @ xx th au th ay sil"	("th-au" "au-th") )
( INST_cy_SPKR_diphone_0406	"sil @ xx dh au dh ay sil"	("dh-au" "au-dh") )
( INST_cy_SPKR_diphone_0407	"sil @ xx s au s ay sil"	("s-au" "au-s") )
( INST_cy_SPKR_diphone_0408	"sil @ xx sh au sh ay sil"	("sh-au" "au-sh") )
( INST_cy_SPKR_diphone_0409	"sil @ xx r au r ay sil"	("r-au" "au-r") )
( INST_cy_SPKR_diphone_0410	"sil @ xx l au l ay sil"	("l-au" "au-l") )
( INST_cy_SPKR_diphone_0411	"sil @ xx m au m ay sil"	("m-au" "au-m") )
( INST_cy_SPKR_diphone_0412	"sil @ xx n au n ay sil"	("n-au" "au-n") )
( INST_cy_SPKR_diphone_0413	"sil @ xx ch au ch ay sil"	("ch-au" "au-ch") )
( INST_cy_SPKR_diphone_0414	"sil @ xx jh au jh ay sil"	("jh-au" "au-jh") )
( INST_cy_SPKR_diphone_0415	"sil @ xx lh au lh ay sil"	("lh-au" "au-lh") )
( INST_cy_SPKR_diphone_0416	"sil @ xx x au x ay sil"	("x-au" "au-x") )
( INST_cy_SPKR_diphone_0417	"sil @ xx hh au hh ay sil"	("hh-au" "au-hh") )
( INST_cy_SPKR_diphone_0418	"sil @ xx z au z ay sil"	("z-au" "au-z") )
( INST_cy_SPKR_diphone_0419	"sil @ xx p ou p ay sil"	("p-ou" "ou-p") )
( INST_cy_SPKR_diphone_0420	"sil @ xx t ou t ay sil"	("t-ou" "ou-t") )
( INST_cy_SPKR_diphone_0421	"sil @ xx k ou k ay sil"	("k-ou" "ou-k") )
( INST_cy_SPKR_diphone_0422	"sil @ xx b ou b ay sil"	("b-ou" "ou-b") )
( INST_cy_SPKR_diphone_0423	"sil @ xx d ou d ay sil"	("d-ou" "ou-d") )
( INST_cy_SPKR_diphone_0424	"sil @ xx g ou g ay sil"	("g-ou" "ou-g") )
( INST_cy_SPKR_diphone_0425	"sil @ xx f ou f ay sil"	("f-ou" "ou-f") )
( INST_cy_SPKR_diphone_0426	"sil @ xx v ou v ay sil"	("v-ou" "ou-v") )
( INST_cy_SPKR_diphone_0427	"sil @ xx th ou th ay sil"	("th-ou" "ou-th") )
( INST_cy_SPKR_diphone_0428	"sil @ xx dh ou dh ay sil"	("dh-ou" "ou-dh") )
( INST_cy_SPKR_diphone_0429	"sil @ xx s ou s ay sil"	("s-ou" "ou-s") )
( INST_cy_SPKR_diphone_0430	"sil @ xx sh ou sh ay sil"	("sh-ou" "ou-sh") )
( INST_cy_SPKR_diphone_0431	"sil @ xx r ou r ay sil"	("r-ou" "ou-r") )
( INST_cy_SPKR_diphone_0432	"sil @ xx l ou l ay sil"	("l-ou" "ou-l") )
( INST_cy_SPKR_diphone_0433	"sil @ xx m ou m ay sil"	("m-ou" "ou-m") )
( INST_cy_SPKR_diphone_0434	"sil @ xx n ou n ay sil"	("n-ou" "ou-n") )
( INST_cy_SPKR_diphone_0435	"sil @ xx ch ou ch ay sil"	("ch-ou" "ou-ch") )
( INST_cy_SPKR_diphone_0436	"sil @ xx jh ou jh ay sil"	("jh-ou" "ou-jh") )
( INST_cy_SPKR_diphone_0437	"sil @ xx lh ou lh ay sil"	("lh-ou" "ou-lh") )
( INST_cy_SPKR_diphone_0438	"sil @ xx x ou x ay sil"	("x-ou" "ou-x") )
( INST_cy_SPKR_diphone_0439	"sil @ xx hh ou hh ay sil"	("hh-ou" "ou-hh") )
( INST_cy_SPKR_diphone_0440	"sil @ xx z ou z ay sil"	("z-ou" "ou-z") )
( INST_cy_SPKR_diphone_0441	"sil @ xx p uy p ay sil"	("p-uy" "uy-p") )
( INST_cy_SPKR_diphone_0442	"sil @ xx t uy t ay sil"	("t-uy" "uy-t") )
( INST_cy_SPKR_diphone_0443	"sil @ xx k uy k ay sil"	("k-uy" "uy-k") )
( INST_cy_SPKR_diphone_0444	"sil @ xx b uy b ay sil"	("b-uy" "uy-b") )
( INST_cy_SPKR_diphone_0445	"sil @ xx d uy d ay sil"	("d-uy" "uy-d") )
( INST_cy_SPKR_diphone_0446	"sil @ xx g uy g ay sil"	("g-uy" "uy-g") )
( INST_cy_SPKR_diphone_0447	"sil @ xx f uy f ay sil"	("f-uy" "uy-f") )
( INST_cy_SPKR_diphone_0448	"sil @ xx v uy v ay sil"	("v-uy" "uy-v") )
( INST_cy_SPKR_diphone_0449	"sil @ xx th uy th ay sil"	("th-uy" "uy-th") )
( INST_cy_SPKR_diphone_0450	"sil @ xx dh uy dh ay sil"	("dh-uy" "uy-dh") )
( INST_cy_SPKR_diphone_0451	"sil @ xx s uy s ay sil"	("s-uy" "uy-s") )
( INST_cy_SPKR_diphone_0452	"sil @ xx sh uy sh ay sil"	("sh-uy" "uy-sh") )
( INST_cy_SPKR_diphone_0453	"sil @ xx r uy r ay sil"	("r-uy" "uy-r") )
( INST_cy_SPKR_diphone_0454	"sil @ xx l uy l ay sil"	("l-uy" "uy-l") )
( INST_cy_SPKR_diphone_0455	"sil @ xx m uy m ay sil"	("m-uy" "uy-m") )
( INST_cy_SPKR_diphone_0456	"sil @ xx n uy n ay sil"	("n-uy" "uy-n") )
( INST_cy_SPKR_diphone_0457	"sil @ xx ch uy ch ay sil"	("ch-uy" "uy-ch") )
( INST_cy_SPKR_diphone_0458	"sil @ xx jh uy jh ay sil"	("jh-uy" "uy-jh") )
( INST_cy_SPKR_diphone_0459	"sil @ xx lh uy lh ay sil"	("lh-uy" "uy-lh") )
( INST_cy_SPKR_diphone_0460	"sil @ xx x uy x ay sil"	("x-uy" "uy-x") )
( INST_cy_SPKR_diphone_0461	"sil @ xx hh uy hh ay sil"	("hh-uy" "uy-hh") )
( INST_cy_SPKR_diphone_0462	"sil @ xx z uy z ay sil"	("z-uy" "uy-z") )
( INST_cy_SPKR_diphone_0463	"sil @ xx p yu p ay sil"	("p-yu" "yu-p") )
( INST_cy_SPKR_diphone_0464	"sil @ xx t yu t ay sil"	("t-yu" "yu-t") )
( INST_cy_SPKR_diphone_0465	"sil @ xx k yu k ay sil"	("k-yu" "yu-k") )
( INST_cy_SPKR_diphone_0466	"sil @ xx b yu b ay sil"	("b-yu" "yu-b") )
( INST_cy_SPKR_diphone_0467	"sil @ xx d yu d ay sil"	("d-yu" "yu-d") )
( INST_cy_SPKR_diphone_0468	"sil @ xx g yu g ay sil"	("g-yu" "yu-g") )
( INST_cy_SPKR_diphone_0469	"sil @ xx f yu f ay sil"	("f-yu" "yu-f") )
( INST_cy_SPKR_diphone_0470	"sil @ xx v yu v ay sil"	("v-yu" "yu-v") )
( INST_cy_SPKR_diphone_0471	"sil @ xx th yu th ay sil"	("th-yu" "yu-th") )
( INST_cy_SPKR_diphone_0472	"sil @ xx dh yu dh ay sil"	("dh-yu" "yu-dh") )
( INST_cy_SPKR_diphone_0473	"sil @ xx s yu s ay sil"	("s-yu" "yu-s") )
( INST_cy_SPKR_diphone_0474	"sil @ xx sh yu sh ay sil"	("sh-yu" "yu-sh") )
( INST_cy_SPKR_diphone_0475	"sil @ xx r yu r ay sil"	("r-yu" "yu-r") )
( INST_cy_SPKR_diphone_0476	"sil @ xx l yu l ay sil"	("l-yu" "yu-l") )
( INST_cy_SPKR_diphone_0477	"sil @ xx m yu m ay sil"	("m-yu" "yu-m") )
( INST_cy_SPKR_diphone_0478	"sil @ xx n yu n ay sil"	("n-yu" "yu-n") )
( INST_cy_SPKR_diphone_0479	"sil @ xx ch yu ch ay sil"	("ch-yu" "yu-ch") )
( INST_cy_SPKR_diphone_0480	"sil @ xx jh yu jh ay sil"	("jh-yu" "yu-jh") )
( INST_cy_SPKR_diphone_0481	"sil @ xx lh yu lh ay sil"	("lh-yu" "yu-lh") )
( INST_cy_SPKR_diphone_0482	"sil @ xx x yu x ay sil"	("x-yu" "yu-x") )
( INST_cy_SPKR_diphone_0483	"sil @ xx hh yu hh ay sil"	("hh-yu" "yu-hh") )
( INST_cy_SPKR_diphone_0484	"sil @ xx z yu z ay sil"	("z-yu" "yu-z") )
( INST_cy_SPKR_diphone_0485	"sil @ xx p ay p ay sil"	("p-ay" "ay-p") )
( INST_cy_SPKR_diphone_0486	"sil @ xx t ay t ay sil"	("t-ay" "ay-t") )
( INST_cy_SPKR_diphone_0487	"sil @ xx k ay k ay sil"	("k-ay" "ay-k") )
( INST_cy_SPKR_diphone_0488	"sil @ xx b ay b ay sil"	("b-ay" "ay-b") )
( INST_cy_SPKR_diphone_0489	"sil @ xx d ay d ay sil"	("d-ay" "ay-d") )
( INST_cy_SPKR_diphone_0490	"sil @ xx g ay g ay sil"	("g-ay" "ay-g") )
( INST_cy_SPKR_diphone_0491	"sil @ xx f ay f ay sil"	("f-ay" "ay-f") )
( INST_cy_SPKR_diphone_0492	"sil @ xx v ay v ay sil"	("v-ay" "ay-v") )
( INST_cy_SPKR_diphone_0493	"sil @ xx th ay th ay sil"	("th-ay" "ay-th") )
( INST_cy_SPKR_diphone_0494	"sil @ xx dh ay dh ay sil"	("dh-ay" "ay-dh") )
( INST_cy_SPKR_diphone_0495	"sil @ xx s ay s ay sil"	("s-ay" "ay-s") )
( INST_cy_SPKR_diphone_0496	"sil @ xx sh ay sh ay sil"	("sh-ay" "ay-sh") )
( INST_cy_SPKR_diphone_0497	"sil @ xx r ay r ay sil"	("r-ay" "ay-r") )
( INST_cy_SPKR_diphone_0498	"sil @ xx l ay l ay sil"	("l-ay" "ay-l") )
( INST_cy_SPKR_diphone_0499	"sil @ xx m ay m ay sil"	("m-ay" "ay-m") )
( INST_cy_SPKR_diphone_0500	"sil @ xx n ay n ay sil"	("n-ay" "ay-n") )
( INST_cy_SPKR_diphone_0501	"sil @ xx ch ay ch ay sil"	("ch-ay" "ay-ch") )
( INST_cy_SPKR_diphone_0502	"sil @ xx jh ay jh ay sil"	("jh-ay" "ay-jh") )
( INST_cy_SPKR_diphone_0503	"sil @ xx lh ay lh ay sil"	("lh-ay" "ay-lh") )
( INST_cy_SPKR_diphone_0504	"sil @ xx x ay x ay sil"	("x-ay" "ay-x") )
( INST_cy_SPKR_diphone_0505	"sil @ xx hh ay hh ay sil"	("hh-ay" "ay-hh") )
( INST_cy_SPKR_diphone_0506	"sil @ xx z ay z ay sil"	("z-ay" "ay-z") )
( INST_cy_SPKR_diphone_0507	"sil @ xx p aay p ay sil"	("p-aay" "aay-p") )
( INST_cy_SPKR_diphone_0508	"sil @ xx t aay t ay sil"	("t-aay" "aay-t") )
( INST_cy_SPKR_diphone_0509	"sil @ xx k aay k ay sil"	("k-aay" "aay-k") )
( INST_cy_SPKR_diphone_0510	"sil @ xx b aay b ay sil"	("b-aay" "aay-b") )
( INST_cy_SPKR_diphone_0511	"sil @ xx d aay d ay sil"	("d-aay" "aay-d") )
( INST_cy_SPKR_diphone_0512	"sil @ xx g aay g ay sil"	("g-aay" "aay-g") )
( INST_cy_SPKR_diphone_0513	"sil @ xx f aay f ay sil"	("f-aay" "aay-f") )
( INST_cy_SPKR_diphone_0514	"sil @ xx v aay v ay sil"	("v-aay" "aay-v") )
( INST_cy_SPKR_diphone_0515	"sil @ xx th aay th ay sil"	("th-aay" "aay-th") )
( INST_cy_SPKR_diphone_0516	"sil @ xx dh aay dh ay sil"	("dh-aay" "aay-dh") )
( INST_cy_SPKR_diphone_0517	"sil @ xx s aay s ay sil"	("s-aay" "aay-s") )
( INST_cy_SPKR_diphone_0518	"sil @ xx sh aay sh ay sil"	("sh-aay" "aay-sh") )
( INST_cy_SPKR_diphone_0519	"sil @ xx r aay r ay sil"	("r-aay" "aay-r") )
( INST_cy_SPKR_diphone_0520	"sil @ xx l aay l ay sil"	("l-aay" "aay-l") )
( INST_cy_SPKR_diphone_0521	"sil @ xx m aay m ay sil"	("m-aay" "aay-m") )
( INST_cy_SPKR_diphone_0522	"sil @ xx n aay n ay sil"	("n-aay" "aay-n") )
( INST_cy_SPKR_diphone_0523	"sil @ xx ch aay ch ay sil"	("ch-aay" "aay-ch") )
( INST_cy_SPKR_diphone_0524	"sil @ xx jh aay jh ay sil"	("jh-aay" "aay-jh") )
( INST_cy_SPKR_diphone_0525	"sil @ xx lh aay lh ay sil"	("lh-aay" "aay-lh") )
( INST_cy_SPKR_diphone_0526	"sil @ xx x aay x ay sil"	("x-aay" "aay-x") )
( INST_cy_SPKR_diphone_0527	"sil @ xx hh aay hh ay sil"	("hh-aay" "aay-hh") )
( INST_cy_SPKR_diphone_0528	"sil @ xx z aay z ay sil"	("z-aay" "aay-z") )
( INST_cy_SPKR_diphone_0529	"sil @ xx p ey p ay sil"	("p-ey" "ey-p") )
( INST_cy_SPKR_diphone_0530	"sil @ xx t ey t ay sil"	("t-ey" "ey-t") )
( INST_cy_SPKR_diphone_0531	"sil @ xx k ey k ay sil"	("k-ey" "ey-k") )
( INST_cy_SPKR_diphone_0532	"sil @ xx b ey b ay sil"	("b-ey" "ey-b") )
( INST_cy_SPKR_diphone_0533	"sil @ xx d ey d ay sil"	("d-ey" "ey-d") )
( INST_cy_SPKR_diphone_0534	"sil @ xx g ey g ay sil"	("g-ey" "ey-g") )
( INST_cy_SPKR_diphone_0535	"sil @ xx f ey f ay sil"	("f-ey" "ey-f") )
( INST_cy_SPKR_diphone_0536	"sil @ xx v ey v ay sil"	("v-ey" "ey-v") )
( INST_cy_SPKR_diphone_0537	"sil @ xx th ey th ay sil"	("th-ey" "ey-th") )
( INST_cy_SPKR_diphone_0538	"sil @ xx dh ey dh ay sil"	("dh-ey" "ey-dh") )
( INST_cy_SPKR_diphone_0539	"sil @ xx s ey s ay sil"	("s-ey" "ey-s") )
( INST_cy_SPKR_diphone_0540	"sil @ xx sh ey sh ay sil"	("sh-ey" "ey-sh") )
( INST_cy_SPKR_diphone_0541	"sil @ xx r ey r ay sil"	("r-ey" "ey-r") )
( INST_cy_SPKR_diphone_0542	"sil @ xx l ey l ay sil"	("l-ey" "ey-l") )
( INST_cy_SPKR_diphone_0543	"sil @ xx m ey m ay sil"	("m-ey" "ey-m") )
( INST_cy_SPKR_diphone_0544	"sil @ xx n ey n ay sil"	("n-ey" "ey-n") )
( INST_cy_SPKR_diphone_0545	"sil @ xx ch ey ch ay sil"	("ch-ey" "ey-ch") )
( INST_cy_SPKR_diphone_0546	"sil @ xx jh ey jh ay sil"	("jh-ey" "ey-jh") )
( INST_cy_SPKR_diphone_0547	"sil @ xx lh ey lh ay sil"	("lh-ey" "ey-lh") )
( INST_cy_SPKR_diphone_0548	"sil @ xx x ey x ay sil"	("x-ey" "ey-x") )
( INST_cy_SPKR_diphone_0549	"sil @ xx hh ey hh ay sil"	("hh-ey" "ey-hh") )
( INST_cy_SPKR_diphone_0550	"sil @ xx z ey z ay sil"	("z-ey" "ey-z") )
( INST_cy_SPKR_diphone_0551	"sil @ xx p oy p ay sil"	("p-oy" "oy-p") )
( INST_cy_SPKR_diphone_0552	"sil @ xx t oy t ay sil"	("t-oy" "oy-t") )
( INST_cy_SPKR_diphone_0553	"sil @ xx k oy k ay sil"	("k-oy" "oy-k") )
( INST_cy_SPKR_diphone_0554	"sil @ xx b oy b ay sil"	("b-oy" "oy-b") )
( INST_cy_SPKR_diphone_0555	"sil @ xx d oy d ay sil"	("d-oy" "oy-d") )
( INST_cy_SPKR_diphone_0556	"sil @ xx g oy g ay sil"	("g-oy" "oy-g") )
( INST_cy_SPKR_diphone_0557	"sil @ xx f oy f ay sil"	("f-oy" "oy-f") )
( INST_cy_SPKR_diphone_0558	"sil @ xx v oy v ay sil"	("v-oy" "oy-v") )
( INST_cy_SPKR_diphone_0559	"sil @ xx th oy th ay sil"	("th-oy" "oy-th") )
( INST_cy_SPKR_diphone_0560	"sil @ xx dh oy dh ay sil"	("dh-oy" "oy-dh") )
( INST_cy_SPKR_diphone_0561	"sil @ xx s oy s ay sil"	("s-oy" "oy-s") )
( INST_cy_SPKR_diphone_0562	"sil @ xx sh oy sh ay sil"	("sh-oy" "oy-sh") )
( INST_cy_SPKR_diphone_0563	"sil @ xx r oy r ay sil"	("r-oy" "oy-r") )
( INST_cy_SPKR_diphone_0564	"sil @ xx l oy l ay sil"	("l-oy" "oy-l") )
( INST_cy_SPKR_diphone_0565	"sil @ xx m oy m ay sil"	("m-oy" "oy-m") )
( INST_cy_SPKR_diphone_0566	"sil @ xx n oy n ay sil"	("n-oy" "oy-n") )
( INST_cy_SPKR_diphone_0567	"sil @ xx ch oy ch ay sil"	("ch-oy" "oy-ch") )
( INST_cy_SPKR_diphone_0568	"sil @ xx jh oy jh ay sil"	("jh-oy" "oy-jh") )
( INST_cy_SPKR_diphone_0569	"sil @ xx lh oy lh ay sil"	("lh-oy" "oy-lh") )
( INST_cy_SPKR_diphone_0570	"sil @ xx x oy x ay sil"	("x-oy" "oy-x") )
( INST_cy_SPKR_diphone_0571	"sil @ xx hh oy hh ay sil"	("hh-oy" "oy-hh") )
( INST_cy_SPKR_diphone_0572	"sil @ xx z oy z ay sil"	("z-oy" "oy-z") )
( INST_cy_SPKR_diphone_0573	"sil d @ d i xx mh ay sil"	("i-mh") )
( INST_cy_SPKR_diphone_0574	"sil d @ d i xx nh ay sil"	("i-nh") )
( INST_cy_SPKR_diphone_0575	"sil d @ d i xx ngh ay sil"	("i-ngh") )
( INST_cy_SPKR_diphone_0576	"sil d @ d i xx ng ay sil"	("i-ng") )
( INST_cy_SPKR_diphone_0577	"sil d @ d i xx rh ay sil"	("i-rh") )
( INST_cy_SPKR_diphone_0578	"sil d @ d i xx lw ay sil"	("i-lw") )
( INST_cy_SPKR_diphone_0579	"sil d @ d i xx nw ay sil"	("i-nw") )
( INST_cy_SPKR_diphone_0580	"sil d @ d i xx rw ay sil"	("i-rw") )
( INST_cy_SPKR_diphone_0581	"sil d @ d i xx w ay sil"	("i-w") )
( INST_cy_SPKR_diphone_0582	"sil d @ d e xx mh ay sil"	("e-mh") )
( INST_cy_SPKR_diphone_0583	"sil d @ d e xx nh ay sil"	("e-nh") )
( INST_cy_SPKR_diphone_0584	"sil d @ d e xx ngh ay sil"	("e-ngh") )
( INST_cy_SPKR_diphone_0585	"sil d @ d e xx ng ay sil"	("e-ng") )
( INST_cy_SPKR_diphone_0586	"sil d @ d e xx rh ay sil"	("e-rh") )
( INST_cy_SPKR_diphone_0587	"sil d @ d e xx lw ay sil"	("e-lw") )
( INST_cy_SPKR_diphone_0588	"sil d @ d e xx nw ay sil"	("e-nw") )
( INST_cy_SPKR_diphone_0589	"sil d @ d e xx rw ay sil"	("e-rw") )
( INST_cy_SPKR_diphone_0590	"sil d @ d e xx w ay sil"	("e-w") )
( INST_cy_SPKR_diphone_0591	"sil d @ d a xx mh ay sil"	("a-mh") )
( INST_cy_SPKR_diphone_0592	"sil d @ d a xx nh ay sil"	("a-nh") )
( INST_cy_SPKR_diphone_0593	"sil d @ d a xx ngh ay sil"	("a-ngh") )
( INST_cy_SPKR_diphone_0594	"sil d @ d a xx ng ay sil"	("a-ng") )
( INST_cy_SPKR_diphone_0595	"sil d @ d a xx rh ay sil"	("a-rh") )
( INST_cy_SPKR_diphone_0596	"sil d @ d a xx lw ay sil"	("a-lw") )
( INST_cy_SPKR_diphone_0597	"sil d @ d a xx nw ay sil"	("a-nw") )
( INST_cy_SPKR_diphone_0598	"sil d @ d a xx rw ay sil"	("a-rw") )
( INST_cy_SPKR_diphone_0599	"sil d @ d a xx w ay sil"	("a-w") )
( INST_cy_SPKR_diphone_0600	"sil d @ d o xx mh ay sil"	("o-mh") )
( INST_cy_SPKR_diphone_0601	"sil d @ d o xx nh ay sil"	("o-nh") )
( INST_cy_SPKR_diphone_0602	"sil d @ d o xx ngh ay sil"	("o-ngh") )
( INST_cy_SPKR_diphone_0603	"sil d @ d o xx ng ay sil"	("o-ng") )
( INST_cy_SPKR_diphone_0604	"sil d @ d o xx rh ay sil"	("o-rh") )
( INST_cy_SPKR_diphone_0605	"sil d @ d o xx lw ay sil"	("o-lw") )
( INST_cy_SPKR_diphone_0606	"sil d @ d o xx nw ay sil"	("o-nw") )
( INST_cy_SPKR_diphone_0607	"sil d @ d o xx rw ay sil"	("o-rw") )
( INST_cy_SPKR_diphone_0608	"sil d @ d o xx w ay sil"	("o-w") )
( INST_cy_SPKR_diphone_0609	"sil d @ d u xx mh ay sil"	("u-mh") )
( INST_cy_SPKR_diphone_0610	"sil d @ d u xx nh ay sil"	("u-nh") )
( INST_cy_SPKR_diphone_0611	"sil d @ d u xx ngh ay sil"	("u-ngh") )
( INST_cy_SPKR_diphone_0612	"sil d @ d u xx ng ay sil"	("u-ng") )
( INST_cy_SPKR_diphone_0613	"sil d @ d u xx rh ay sil"	("u-rh") )
( INST_cy_SPKR_diphone_0614	"sil d @ d u xx lw ay sil"	("u-lw") )
( INST_cy_SPKR_diphone_0615	"sil d @ d u xx nw ay sil"	("u-nw") )
( INST_cy_SPKR_diphone_0616	"sil d @ d u xx rw ay sil"	("u-rw") )
( INST_cy_SPKR_diphone_0617	"sil d @ d u xx w ay sil"	("u-w") )
( INST_cy_SPKR_diphone_0618	"sil d @ d y xx mh ay sil"	("y-mh") )
( INST_cy_SPKR_diphone_0619	"sil d @ d y xx nh ay sil"	("y-nh") )
( INST_cy_SPKR_diphone_0620	"sil d @ d y xx ngh ay sil"	("y-ngh") )
( INST_cy_SPKR_diphone_0621	"sil d @ d y xx ng ay sil"	("y-ng") )
( INST_cy_SPKR_diphone_0622	"sil d @ d y xx rh ay sil"	("y-rh") )
( INST_cy_SPKR_diphone_0623	"sil d @ d y xx lw ay sil"	("y-lw") )
( INST_cy_SPKR_diphone_0624	"sil d @ d y xx nw ay sil"	("y-nw") )
( INST_cy_SPKR_diphone_0625	"sil d @ d y xx rw ay sil"	("y-rw") )
( INST_cy_SPKR_diphone_0626	"sil d @ d y xx w ay sil"	("y-w") )
( INST_cy_SPKR_diphone_0627	"sil d @ xx mh ay sil"	("@-mh") )
( INST_cy_SPKR_diphone_0628	"sil d @ xx nh ay sil"	("@-nh") )
( INST_cy_SPKR_diphone_0629	"sil d @ xx ngh ay sil"	("@-ngh") )
( INST_cy_SPKR_diphone_0630	"sil d @ xx ng ay sil"	("@-ng") )
( INST_cy_SPKR_diphone_0631	"sil d @ xx rh ay sil"	("@-rh") )
( INST_cy_SPKR_diphone_0632	"sil d @ xx lw ay sil"	("@-lw") )
( INST_cy_SPKR_diphone_0633	"sil d @ xx nw ay sil"	("@-nw") )
( INST_cy_SPKR_diphone_0634	"sil d @ xx rw ay sil"	("@-rw") )
( INST_cy_SPKR_diphone_0635	"sil d @ xx w ay sil"	("@-w") )
( INST_cy_SPKR_diphone_0636	"sil @ xx d ii - mh ay sil"	("ii-mh") )
( INST_cy_SPKR_diphone_0637	"sil @ xx d ii - nh ay sil"	("ii-nh") )
( INST_cy_SPKR_diphone_0638	"sil @ xx d ii - ngh ay sil"	("ii-ngh") )
( INST_cy_SPKR_diphone_0639	"sil @ xx d ii - ng ay sil"	("ii-ng") )
( INST_cy_SPKR_diphone_0640	"sil @ xx d ii - rh ay sil"	("ii-rh") )
( INST_cy_SPKR_diphone_0641	"sil @ xx d ii - lw ay sil"	("ii-lw") )
( INST_cy_SPKR_diphone_0642	"sil @ xx d ii - nw ay sil"	("ii-nw") )
( INST_cy_SPKR_diphone_0643	"sil @ xx d ii - rw ay sil"	("ii-rw") )
( INST_cy_SPKR_diphone_0644	"sil @ xx d ii - w ay sil"	("ii-w") )
( INST_cy_SPKR_diphone_0645	"sil @ xx d ee - mh ay sil"	("ee-mh") )
( INST_cy_SPKR_diphone_0646	"sil @ xx d ee - nh ay sil"	("ee-nh") )
( INST_cy_SPKR_diphone_0647	"sil @ xx d ee - ngh ay sil"	("ee-ngh") )
( INST_cy_SPKR_diphone_0648	"sil @ xx d ee - ng ay sil"	("ee-ng") )
( INST_cy_SPKR_diphone_0649	"sil @ xx d ee - rh ay sil"	("ee-rh") )
( INST_cy_SPKR_diphone_0650	"sil @ xx d ee - lw ay sil"	("ee-lw") )
( INST_cy_SPKR_diphone_0651	"sil @ xx d ee - nw ay sil"	("ee-nw") )
( INST_cy_SPKR_diphone_0652	"sil @ xx d ee - rw ay sil"	("ee-rw") )
( INST_cy_SPKR_diphone_0653	"sil @ xx d ee - w ay sil"	("ee-w") )
( INST_cy_SPKR_diphone_0654	"sil @ xx d aa - mh ay sil"	("aa-mh") )
( INST_cy_SPKR_diphone_0655	"sil @ xx d aa - nh ay sil"	("aa-nh") )
( INST_cy_SPKR_diphone_0656	"sil @ xx d aa - ngh ay sil"	("aa-ngh") )
( INST_cy_SPKR_diphone_0657	"sil @ xx d aa - ng ay sil"	("aa-ng") )
( INST_cy_SPKR_diphone_0658	"sil @ xx d aa - rh ay sil"	("aa-rh") )
( INST_cy_SPKR_diphone_0659	"sil @ xx d aa - lw ay sil"	("aa-lw") )
( INST_cy_SPKR_diphone_0660	"sil @ xx d aa - nw ay sil"	("aa-nw") )
( INST_cy_SPKR_diphone_0661	"sil @ xx d aa - rw ay sil"	("aa-rw") )
( INST_cy_SPKR_diphone_0662	"sil @ xx d aa - w ay sil"	("aa-w") )
( INST_cy_SPKR_diphone_0663	"sil @ xx d oo - mh ay sil"	("oo-mh") )
( INST_cy_SPKR_diphone_0664	"sil @ xx d oo - nh ay sil"	("oo-nh") )
( INST_cy_SPKR_diphone_0665	"sil @ xx d oo - ngh ay sil"	("oo-ngh") )
( INST_cy_SPKR_diphone_0666	"sil @ xx d oo - ng ay sil"	("oo-ng") )
( INST_cy_SPKR_diphone_0667	"sil @ xx d oo - rh ay sil"	("oo-rh") )
( INST_cy_SPKR_diphone_0668	"sil @ xx d oo - lw ay sil"	("oo-lw") )
( INST_cy_SPKR_diphone_0669	"sil @ xx d oo - nw ay sil"	("oo-nw") )
( INST_cy_SPKR_diphone_0670	"sil @ xx d oo - rw ay sil"	("oo-rw") )
( INST_cy_SPKR_diphone_0671	"sil @ xx d oo - w ay sil"	("oo-w") )
( INST_cy_SPKR_diphone_0672	"sil @ xx d uu - mh ay sil"	("uu-mh") )
( INST_cy_SPKR_diphone_0673	"sil @ xx d uu - nh ay sil"	("uu-nh") )
( INST_cy_SPKR_diphone_0674	"sil @ xx d uu - ngh ay sil"	("uu-ngh") )
( INST_cy_SPKR_diphone_0675	"sil @ xx d uu - ng ay sil"	("uu-ng") )
( INST_cy_SPKR_diphone_0676	"sil @ xx d uu - rh ay sil"	("uu-rh") )
( INST_cy_SPKR_diphone_0677	"sil @ xx d uu - lw ay sil"	("uu-lw") )
( INST_cy_SPKR_diphone_0678	"sil @ xx d uu - nw ay sil"	("uu-nw") )
( INST_cy_SPKR_diphone_0679	"sil @ xx d uu - rw ay sil"	("uu-rw") )
( INST_cy_SPKR_diphone_0680	"sil @ xx d uu - w ay sil"	("uu-w") )
( INST_cy_SPKR_diphone_0681	"sil @ xx d yy - mh ay sil"	("yy-mh") )
( INST_cy_SPKR_diphone_0682	"sil @ xx d yy - nh ay sil"	("yy-nh") )
( INST_cy_SPKR_diphone_0683	"sil @ xx d yy - ngh ay sil"	("yy-ngh") )
( INST_cy_SPKR_diphone_0684	"sil @ xx d yy - ng ay sil"	("yy-ng") )
( INST_cy_SPKR_diphone_0685	"sil @ xx d yy - rh ay sil"	("yy-rh") )
( INST_cy_SPKR_diphone_0686	"sil @ xx d yy - lw ay sil"	("yy-lw") )
( INST_cy_SPKR_diphone_0687	"sil @ xx d yy - nw ay sil"	("yy-nw") )
( INST_cy_SPKR_diphone_0688	"sil @ xx d yy - rw ay sil"	("yy-rw") )
( INST_cy_SPKR_diphone_0689	"sil @ xx d yy - w ay sil"	("yy-w") )
( INST_cy_SPKR_diphone_0690	"sil @ xx d ei - mh ay sil"	("ei-mh") )
( INST_cy_SPKR_diphone_0691	"sil @ xx d ei - nh ay sil"	("ei-nh") )
( INST_cy_SPKR_diphone_0692	"sil @ xx d ei - ngh ay sil"	("ei-ngh") )
( INST_cy_SPKR_diphone_0693	"sil @ xx d ei - ng ay sil"	("ei-ng") )
( INST_cy_SPKR_diphone_0694	"sil @ xx d ei - rh ay sil"	("ei-rh") )
( INST_cy_SPKR_diphone_0695	"sil @ xx d ei - lw ay sil"	("ei-lw") )
( INST_cy_SPKR_diphone_0696	"sil @ xx d ei - nw ay sil"	("ei-nw") )
( INST_cy_SPKR_diphone_0697	"sil @ xx d ei - rw ay sil"	("ei-rw") )
( INST_cy_SPKR_diphone_0698	"sil @ xx d ei - w ay sil"	("ei-w") )
( INST_cy_SPKR_diphone_0699	"sil @ xx d ai - mh ay sil"	("ai-mh") )
( INST_cy_SPKR_diphone_0700	"sil @ xx d ai - nh ay sil"	("ai-nh") )
( INST_cy_SPKR_diphone_0701	"sil @ xx d ai - ngh ay sil"	("ai-ngh") )
( INST_cy_SPKR_diphone_0702	"sil @ xx d ai - ng ay sil"	("ai-ng") )
( INST_cy_SPKR_diphone_0703	"sil @ xx d ai - rh ay sil"	("ai-rh") )
( INST_cy_SPKR_diphone_0704	"sil @ xx d ai - lw ay sil"	("ai-lw") )
( INST_cy_SPKR_diphone_0705	"sil @ xx d ai - nw ay sil"	("ai-nw") )
( INST_cy_SPKR_diphone_0706	"sil @ xx d ai - rw ay sil"	("ai-rw") )
( INST_cy_SPKR_diphone_0707	"sil @ xx d ai - w ay sil"	("ai-w") )
( INST_cy_SPKR_diphone_0708	"sil @ xx d oi - mh ay sil"	("oi-mh") )
( INST_cy_SPKR_diphone_0709	"sil @ xx d oi - nh ay sil"	("oi-nh") )
( INST_cy_SPKR_diphone_0710	"sil @ xx d oi - ngh ay sil"	("oi-ngh") )
( INST_cy_SPKR_diphone_0711	"sil @ xx d oi - ng ay sil"	("oi-ng") )
( INST_cy_SPKR_diphone_0712	"sil @ xx d oi - rh ay sil"	("oi-rh") )
( INST_cy_SPKR_diphone_0713	"sil @ xx d oi - lw ay sil"	("oi-lw") )
( INST_cy_SPKR_diphone_0714	"sil @ xx d oi - nw ay sil"	("oi-nw") )
( INST_cy_SPKR_diphone_0715	"sil @ xx d oi - rw ay sil"	("oi-rw") )
( INST_cy_SPKR_diphone_0716	"sil @ xx d oi - w ay sil"	("oi-w") )
( INST_cy_SPKR_diphone_0717	"sil @ xx d iu - mh ay sil"	("iu-mh") )
( INST_cy_SPKR_diphone_0718	"sil @ xx d iu - nh ay sil"	("iu-nh") )
( INST_cy_SPKR_diphone_0719	"sil @ xx d iu - ngh ay sil"	("iu-ngh") )
( INST_cy_SPKR_diphone_0720	"sil @ xx d iu - ng ay sil"	("iu-ng") )
( INST_cy_SPKR_diphone_0721	"sil @ xx d iu - rh ay sil"	("iu-rh") )
( INST_cy_SPKR_diphone_0722	"sil @ xx d iu - lw ay sil"	("iu-lw") )
( INST_cy_SPKR_diphone_0723	"sil @ xx d iu - nw ay sil"	("iu-nw") )
( INST_cy_SPKR_diphone_0724	"sil @ xx d iu - rw ay sil"	("iu-rw") )
( INST_cy_SPKR_diphone_0725	"sil @ xx d iu - w ay sil"	("iu-w") )
( INST_cy_SPKR_diphone_0726	"sil @ xx d eu - mh ay sil"	("eu-mh") )
( INST_cy_SPKR_diphone_0727	"sil @ xx d eu - nh ay sil"	("eu-nh") )
( INST_cy_SPKR_diphone_0728	"sil @ xx d eu - ngh ay sil"	("eu-ngh") )
( INST_cy_SPKR_diphone_0729	"sil @ xx d eu - ng ay sil"	("eu-ng") )
( INST_cy_SPKR_diphone_0730	"sil @ xx d eu - rh ay sil"	("eu-rh") )
( INST_cy_SPKR_diphone_0731	"sil @ xx d eu - lw ay sil"	("eu-lw") )
( INST_cy_SPKR_diphone_0732	"sil @ xx d eu - nw ay sil"	("eu-nw") )
( INST_cy_SPKR_diphone_0733	"sil @ xx d eu - rw ay sil"	("eu-rw") )
( INST_cy_SPKR_diphone_0734	"sil @ xx d eu - w ay sil"	("eu-w") )
( INST_cy_SPKR_diphone_0735	"sil @ xx d au - mh ay sil"	("au-mh") )
( INST_cy_SPKR_diphone_0736	"sil @ xx d au - nh ay sil"	("au-nh") )
( INST_cy_SPKR_diphone_0737	"sil @ xx d au - ngh ay sil"	("au-ngh") )
( INST_cy_SPKR_diphone_0738	"sil @ xx d au - ng ay sil"	("au-ng") )
( INST_cy_SPKR_diphone_0739	"sil @ xx d au - rh ay sil"	("au-rh") )
( INST_cy_SPKR_diphone_0740	"sil @ xx d au - lw ay sil"	("au-lw") )
( INST_cy_SPKR_diphone_0741	"sil @ xx d au - nw ay sil"	("au-nw") )
( INST_cy_SPKR_diphone_0742	"sil @ xx d au - rw ay sil"	("au-rw") )
( INST_cy_SPKR_diphone_0743	"sil @ xx d au - w ay sil"	("au-w") )
( INST_cy_SPKR_diphone_0744	"sil @ xx d ou - mh ay sil"	("ou-mh") )
( INST_cy_SPKR_diphone_0745	"sil @ xx d ou - nh ay sil"	("ou-nh") )
( INST_cy_SPKR_diphone_0746	"sil @ xx d ou - ngh ay sil"	("ou-ngh") )
( INST_cy_SPKR_diphone_0747	"sil @ xx d ou - ng ay sil"	("ou-ng") )
( INST_cy_SPKR_diphone_0748	"sil @ xx d ou - rh ay sil"	("ou-rh") )
( INST_cy_SPKR_diphone_0749	"sil @ xx d ou - lw ay sil"	("ou-lw") )
( INST_cy_SPKR_diphone_0750	"sil @ xx d ou - nw ay sil"	("ou-nw") )
( INST_cy_SPKR_diphone_0751	"sil @ xx d ou - rw ay sil"	("ou-rw") )
( INST_cy_SPKR_diphone_0752	"sil @ xx d ou - w ay sil"	("ou-w") )
( INST_cy_SPKR_diphone_0753	"sil @ xx d uy - mh ay sil"	("uy-mh") )
( INST_cy_SPKR_diphone_0754	"sil @ xx d uy - nh ay sil"	("uy-nh") )
( INST_cy_SPKR_diphone_0755	"sil @ xx d uy - ngh ay sil"	("uy-ngh") )
( INST_cy_SPKR_diphone_0756	"sil @ xx d uy - ng ay sil"	("uy-ng") )
( INST_cy_SPKR_diphone_0757	"sil @ xx d uy - rh ay sil"	("uy-rh") )
( INST_cy_SPKR_diphone_0758	"sil @ xx d uy - lw ay sil"	("uy-lw") )
( INST_cy_SPKR_diphone_0759	"sil @ xx d uy - nw ay sil"	("uy-nw") )
( INST_cy_SPKR_diphone_0760	"sil @ xx d uy - rw ay sil"	("uy-rw") )
( INST_cy_SPKR_diphone_0761	"sil @ xx d uy - w ay sil"	("uy-w") )
( INST_cy_SPKR_diphone_0762	"sil @ xx d yu - mh ay sil"	("yu-mh") )
( INST_cy_SPKR_diphone_0763	"sil @ xx d yu - nh ay sil"	("yu-nh") )
( INST_cy_SPKR_diphone_0764	"sil @ xx d yu - ngh ay sil"	("yu-ngh") )
( INST_cy_SPKR_diphone_0765	"sil @ xx d yu - ng ay sil"	("yu-ng") )
( INST_cy_SPKR_diphone_0766	"sil @ xx d yu - rh ay sil"	("yu-rh") )
( INST_cy_SPKR_diphone_0767	"sil @ xx d yu - lw ay sil"	("yu-lw") )
( INST_cy_SPKR_diphone_0768	"sil @ xx d yu - nw ay sil"	("yu-nw") )
( INST_cy_SPKR_diphone_0769	"sil @ xx d yu - rw ay sil"	("yu-rw") )
( INST_cy_SPKR_diphone_0770	"sil @ xx d yu - w ay sil"	("yu-w") )
( INST_cy_SPKR_diphone_0771	"sil @ xx d ay - mh ay sil"	("ay-mh") )
( INST_cy_SPKR_diphone_0772	"sil @ xx d ay - nh ay sil"	("ay-nh") )
( INST_cy_SPKR_diphone_0773	"sil @ xx d ay - ngh ay sil"	("ay-ngh") )
( INST_cy_SPKR_diphone_0774	"sil @ xx d ay - ng ay sil"	("ay-ng") )
( INST_cy_SPKR_diphone_0775	"sil @ xx d ay - rh ay sil"	("ay-rh") )
( INST_cy_SPKR_diphone_0776	"sil @ xx d ay - lw ay sil"	("ay-lw") )
( INST_cy_SPKR_diphone_0777	"sil @ xx d ay - nw ay sil"	("ay-nw") )
( INST_cy_SPKR_diphone_0778	"sil @ xx d ay - rw ay sil"	("ay-rw") )
( INST_cy_SPKR_diphone_0779	"sil @ xx d ay - w ay sil"	("ay-w") )
( INST_cy_SPKR_diphone_0780	"sil @ xx d aay - mh ay sil"	("aay-mh") )
( INST_cy_SPKR_diphone_0781	"sil @ xx d aay - nh ay sil"	("aay-nh") )
( INST_cy_SPKR_diphone_0782	"sil @ xx d aay - ngh ay sil"	("aay-ngh") )
( INST_cy_SPKR_diphone_0783	"sil @ xx d aay - ng ay sil"	("aay-ng") )
( INST_cy_SPKR_diphone_0784	"sil @ xx d aay - rh ay sil"	("aay-rh") )
( INST_cy_SPKR_diphone_0785	"sil @ xx d aay - lw ay sil"	("aay-lw") )
( INST_cy_SPKR_diphone_0786	"sil @ xx d aay - nw ay sil"	("aay-nw") )
( INST_cy_SPKR_diphone_0787	"sil @ xx d aay - rw ay sil"	("aay-rw") )
( INST_cy_SPKR_diphone_0788	"sil @ xx d aay - w ay sil"	("aay-w") )
( INST_cy_SPKR_diphone_0789	"sil @ xx d ey - mh ay sil"	("ey-mh") )
( INST_cy_SPKR_diphone_0790	"sil @ xx d ey - nh ay sil"	("ey-nh") )
( INST_cy_SPKR_diphone_0791	"sil @ xx d ey - ngh ay sil"	("ey-ngh") )
( INST_cy_SPKR_diphone_0792	"sil @ xx d ey - ng ay sil"	("ey-ng") )
( INST_cy_SPKR_diphone_0793	"sil @ xx d ey - rh ay sil"	("ey-rh") )
( INST_cy_SPKR_diphone_0794	"sil @ xx d ey - lw ay sil"	("ey-lw") )
( INST_cy_SPKR_diphone_0795	"sil @ xx d ey - nw ay sil"	("ey-nw") )
( INST_cy_SPKR_diphone_0796	"sil @ xx d ey - rw ay sil"	("ey-rw") )
( INST_cy_SPKR_diphone_0797	"sil @ xx d ey - w ay sil"	("ey-w") )
( INST_cy_SPKR_diphone_0798	"sil @ xx d oy - mh ay sil"	("oy-mh") )
( INST_cy_SPKR_diphone_0799	"sil @ xx d oy - nh ay sil"	("oy-nh") )
( INST_cy_SPKR_diphone_0800	"sil @ xx d oy - ngh ay sil"	("oy-ngh") )
( INST_cy_SPKR_diphone_0801	"sil @ xx d oy - ng ay sil"	("oy-ng") )
( INST_cy_SPKR_diphone_0802	"sil @ xx d oy - rh ay sil"	("oy-rh") )
( INST_cy_SPKR_diphone_0803	"sil @ xx d oy - lw ay sil"	("oy-lw") )
( INST_cy_SPKR_diphone_0804	"sil @ xx d oy - nw ay sil"	("oy-nw") )
( INST_cy_SPKR_diphone_0805	"sil @ xx d oy - rw ay sil"	("oy-rw") )
( INST_cy_SPKR_diphone_0806	"sil @ xx d oy - w ay sil"	("oy-w") )
( INST_cy_SPKR_diphone_0807	"sil d @ d i xx j ay sil"	("i-j") )
( INST_cy_SPKR_diphone_0808	"sil d @ d e xx j ay sil"	("e-j") )
( INST_cy_SPKR_diphone_0809	"sil d @ d a xx j ay sil"	("a-j") )
( INST_cy_SPKR_diphone_0810	"sil d @ d o xx j ay sil"	("o-j") )
( INST_cy_SPKR_diphone_0811	"sil d @ d u xx j ay sil"	("u-j") )
( INST_cy_SPKR_diphone_0812	"sil d @ d y xx j ay sil"	("y-j") )
( INST_cy_SPKR_diphone_0813	"sil d @ xx j ay sil"	("@-j") )
( INST_cy_SPKR_diphone_0814	"sil @ xx d ii - j ay sil"	("ii-j") )
( INST_cy_SPKR_diphone_0815	"sil @ xx d ee - j ay sil"	("ee-j") )
( INST_cy_SPKR_diphone_0816	"sil @ xx d aa - j ay sil"	("aa-j") )
( INST_cy_SPKR_diphone_0817	"sil @ xx d oo - j ay sil"	("oo-j") )
( INST_cy_SPKR_diphone_0818	"sil @ xx d uu - j ay sil"	("uu-j") )
( INST_cy_SPKR_diphone_0819	"sil @ xx d yy - j ay sil"	("yy-j") )
( INST_cy_SPKR_diphone_0820	"sil @ xx d ei - j ay sil"	("ei-j") )
( INST_cy_SPKR_diphone_0821	"sil @ xx d ai - j ay sil"	("ai-j") )
( INST_cy_SPKR_diphone_0822	"sil @ xx d oi - j ay sil"	("oi-j") )
( INST_cy_SPKR_diphone_0823	"sil @ xx d iu - j ay sil"	("iu-j") )
( INST_cy_SPKR_diphone_0824	"sil @ xx d eu - j ay sil"	("eu-j") )
( INST_cy_SPKR_diphone_0825	"sil @ xx d au - j ay sil"	("au-j") )
( INST_cy_SPKR_diphone_0826	"sil @ xx d ou - j ay sil"	("ou-j") )
( INST_cy_SPKR_diphone_0827	"sil @ xx d uy - j ay sil"	("uy-j") )
( INST_cy_SPKR_diphone_0828	"sil @ xx d yu - j ay sil"	("yu-j") )
( INST_cy_SPKR_diphone_0829	"sil @ xx d ay - j ay sil"	("ay-j") )
( INST_cy_SPKR_diphone_0830	"sil @ xx d aay - j ay sil"	("aay-j") )
( INST_cy_SPKR_diphone_0831	"sil @ xx d ey - j ay sil"	("ey-j") )
( INST_cy_SPKR_diphone_0832	"sil @ xx d oy - j ay sil"	("oy-j") )
( INST_cy_SPKR_diphone_0833	"sil @ xx mh i d ay sil"	("mh-i") )
( INST_cy_SPKR_diphone_0834	"sil @ xx mh e d ay sil"	("mh-e") )
( INST_cy_SPKR_diphone_0835	"sil @ xx mh a d ay sil"	("mh-a") )
( INST_cy_SPKR_diphone_0836	"sil @ xx mh o d ay sil"	("mh-o") )
( INST_cy_SPKR_diphone_0837	"sil @ xx mh u d ay sil"	("mh-u") )
( INST_cy_SPKR_diphone_0838	"sil @ xx mh y d ay sil"	("mh-y") )
( INST_cy_SPKR_diphone_0839	"sil @ xx mh @ d ay sil"	("mh-@") )
( INST_cy_SPKR_diphone_0840	"sil @ xx mh ii d ay sil"	("mh-ii") )
( INST_cy_SPKR_diphone_0841	"sil @ xx mh ee d ay sil"	("mh-ee") )
( INST_cy_SPKR_diphone_0842	"sil @ xx mh aa d ay sil"	("mh-aa") )
( INST_cy_SPKR_diphone_0843	"sil @ xx mh oo d ay sil"	("mh-oo") )
( INST_cy_SPKR_diphone_0844	"sil @ xx mh uu d ay sil"	("mh-uu") )
( INST_cy_SPKR_diphone_0845	"sil @ xx mh yy d ay sil"	("mh-yy") )
( INST_cy_SPKR_diphone_0846	"sil @ xx mh ei d ay sil"	("mh-ei") )
( INST_cy_SPKR_diphone_0847	"sil @ xx mh ai d ay sil"	("mh-ai") )
( INST_cy_SPKR_diphone_0848	"sil @ xx mh oi d ay sil"	("mh-oi") )
( INST_cy_SPKR_diphone_0849	"sil @ xx mh iu d ay sil"	("mh-iu") )
( INST_cy_SPKR_diphone_0850	"sil @ xx mh eu d ay sil"	("mh-eu") )
( INST_cy_SPKR_diphone_0851	"sil @ xx mh au d ay sil"	("mh-au") )
( INST_cy_SPKR_diphone_0852	"sil @ xx mh ou d ay sil"	("mh-ou") )
( INST_cy_SPKR_diphone_0853	"sil @ xx mh uy d ay sil"	("mh-uy") )
( INST_cy_SPKR_diphone_0854	"sil @ xx mh yu d ay sil"	("mh-yu") )
( INST_cy_SPKR_diphone_0855	"sil @ xx mh ay d ay sil"	("mh-ay") )
( INST_cy_SPKR_diphone_0856	"sil @ xx mh aay d ay sil"	("mh-aay") )
( INST_cy_SPKR_diphone_0857	"sil @ xx mh ey d ay sil"	("mh-ey") )
( INST_cy_SPKR_diphone_0858	"sil @ xx mh oy d ay sil"	("mh-oy") )
( INST_cy_SPKR_diphone_0859	"sil @ xx nh i d ay sil"	("nh-i") )
( INST_cy_SPKR_diphone_0860	"sil @ xx nh e d ay sil"	("nh-e") )
( INST_cy_SPKR_diphone_0861	"sil @ xx nh a d ay sil"	("nh-a") )
( INST_cy_SPKR_diphone_0862	"sil @ xx nh o d ay sil"	("nh-o") )
( INST_cy_SPKR_diphone_0863	"sil @ xx nh u d ay sil"	("nh-u") )
( INST_cy_SPKR_diphone_0864	"sil @ xx nh y d ay sil"	("nh-y") )
( INST_cy_SPKR_diphone_0865	"sil @ xx nh @ d ay sil"	("nh-@") )
( INST_cy_SPKR_diphone_0866	"sil @ xx nh ii d ay sil"	("nh-ii") )
( INST_cy_SPKR_diphone_0867	"sil @ xx nh ee d ay sil"	("nh-ee") )
( INST_cy_SPKR_diphone_0868	"sil @ xx nh aa d ay sil"	("nh-aa") )
( INST_cy_SPKR_diphone_0869	"sil @ xx nh oo d ay sil"	("nh-oo") )
( INST_cy_SPKR_diphone_0870	"sil @ xx nh uu d ay sil"	("nh-uu") )
( INST_cy_SPKR_diphone_0871	"sil @ xx nh yy d ay sil"	("nh-yy") )
( INST_cy_SPKR_diphone_0872	"sil @ xx nh ei d ay sil"	("nh-ei") )
( INST_cy_SPKR_diphone_0873	"sil @ xx nh ai d ay sil"	("nh-ai") )
( INST_cy_SPKR_diphone_0874	"sil @ xx nh oi d ay sil"	("nh-oi") )
( INST_cy_SPKR_diphone_0875	"sil @ xx nh iu d ay sil"	("nh-iu") )
( INST_cy_SPKR_diphone_0876	"sil @ xx nh eu d ay sil"	("nh-eu") )
( INST_cy_SPKR_diphone_0877	"sil @ xx nh au d ay sil"	("nh-au") )
( INST_cy_SPKR_diphone_0878	"sil @ xx nh ou d ay sil"	("nh-ou") )
( INST_cy_SPKR_diphone_0879	"sil @ xx nh uy d ay sil"	("nh-uy") )
( INST_cy_SPKR_diphone_0880	"sil @ xx nh yu d ay sil"	("nh-yu") )
( INST_cy_SPKR_diphone_0881	"sil @ xx nh ay d ay sil"	("nh-ay") )
( INST_cy_SPKR_diphone_0882	"sil @ xx nh aay d ay sil"	("nh-aay") )
( INST_cy_SPKR_diphone_0883	"sil @ xx nh ey d ay sil"	("nh-ey") )
( INST_cy_SPKR_diphone_0884	"sil @ xx nh oy d ay sil"	("nh-oy") )
( INST_cy_SPKR_diphone_0885	"sil @ xx ngh i d ay sil"	("ngh-i") )
( INST_cy_SPKR_diphone_0886	"sil @ xx ngh e d ay sil"	("ngh-e") )
( INST_cy_SPKR_diphone_0887	"sil @ xx ngh a d ay sil"	("ngh-a") )
( INST_cy_SPKR_diphone_0888	"sil @ xx ngh o d ay sil"	("ngh-o") )
( INST_cy_SPKR_diphone_0889	"sil @ xx ngh u d ay sil"	("ngh-u") )
( INST_cy_SPKR_diphone_0890	"sil @ xx ngh y d ay sil"	("ngh-y") )
( INST_cy_SPKR_diphone_0891	"sil @ xx ngh @ d ay sil"	("ngh-@") )
( INST_cy_SPKR_diphone_0892	"sil @ xx ngh ii d ay sil"	("ngh-ii") )
( INST_cy_SPKR_diphone_0893	"sil @ xx ngh ee d ay sil"	("ngh-ee") )
( INST_cy_SPKR_diphone_0894	"sil @ xx ngh aa d ay sil"	("ngh-aa") )
( INST_cy_SPKR_diphone_0895	"sil @ xx ngh oo d ay sil"	("ngh-oo") )
( INST_cy_SPKR_diphone_0896	"sil @ xx ngh uu d ay sil"	("ngh-uu") )
( INST_cy_SPKR_diphone_0897	"sil @ xx ngh yy d ay sil"	("ngh-yy") )
( INST_cy_SPKR_diphone_0898	"sil @ xx ngh ei d ay sil"	("ngh-ei") )
( INST_cy_SPKR_diphone_0899	"sil @ xx ngh ai d ay sil"	("ngh-ai") )
( INST_cy_SPKR_diphone_0900	"sil @ xx ngh oi d ay sil"	("ngh-oi") )
( INST_cy_SPKR_diphone_0901	"sil @ xx ngh iu d ay sil"	("ngh-iu") )
( INST_cy_SPKR_diphone_0902	"sil @ xx ngh eu d ay sil"	("ngh-eu") )
( INST_cy_SPKR_diphone_0903	"sil @ xx ngh au d ay sil"	("ngh-au") )
( INST_cy_SPKR_diphone_0904	"sil @ xx ngh ou d ay sil"	("ngh-ou") )
( INST_cy_SPKR_diphone_0905	"sil @ xx ngh uy d ay sil"	("ngh-uy") )
( INST_cy_SPKR_diphone_0906	"sil @ xx ngh yu d ay sil"	("ngh-yu") )
( INST_cy_SPKR_diphone_0907	"sil @ xx ngh ay d ay sil"	("ngh-ay") )
( INST_cy_SPKR_diphone_0908	"sil @ xx ngh aay d ay sil"	("ngh-aay") )
( INST_cy_SPKR_diphone_0909	"sil @ xx ngh ey d ay sil"	("ngh-ey") )
( INST_cy_SPKR_diphone_0910	"sil @ xx ngh oy d ay sil"	("ngh-oy") )
( INST_cy_SPKR_diphone_0911	"sil @ xx ng i d ay sil"	("ng-i") )
( INST_cy_SPKR_diphone_0912	"sil @ xx ng e d ay sil"	("ng-e") )
( INST_cy_SPKR_diphone_0913	"sil @ xx ng a d ay sil"	("ng-a") )
( INST_cy_SPKR_diphone_0914	"sil @ xx ng o d ay sil"	("ng-o") )
( INST_cy_SPKR_diphone_0915	"sil @ xx ng u d ay sil"	("ng-u") )
( INST_cy_SPKR_diphone_0916	"sil @ xx ng y d ay sil"	("ng-y") )
( INST_cy_SPKR_diphone_0917	"sil @ xx ng @ d ay sil"	("ng-@") )
( INST_cy_SPKR_diphone_0918	"sil @ xx ng ii d ay sil"	("ng-ii") )
( INST_cy_SPKR_diphone_0919	"sil @ xx ng ee d ay sil"	("ng-ee") )
( INST_cy_SPKR_diphone_0920	"sil @ xx ng aa d ay sil"	("ng-aa") )
( INST_cy_SPKR_diphone_0921	"sil @ xx ng oo d ay sil"	("ng-oo") )
( INST_cy_SPKR_diphone_0922	"sil @ xx ng uu d ay sil"	("ng-uu") )
( INST_cy_SPKR_diphone_0923	"sil @ xx ng yy d ay sil"	("ng-yy") )
( INST_cy_SPKR_diphone_0924	"sil @ xx ng ei d ay sil"	("ng-ei") )
( INST_cy_SPKR_diphone_0925	"sil @ xx ng ai d ay sil"	("ng-ai") )
( INST_cy_SPKR_diphone_0926	"sil @ xx ng oi d ay sil"	("ng-oi") )
( INST_cy_SPKR_diphone_0927	"sil @ xx ng iu d ay sil"	("ng-iu") )
( INST_cy_SPKR_diphone_0928	"sil @ xx ng eu d ay sil"	("ng-eu") )
( INST_cy_SPKR_diphone_0929	"sil @ xx ng au d ay sil"	("ng-au") )
( INST_cy_SPKR_diphone_0930	"sil @ xx ng ou d ay sil"	("ng-ou") )
( INST_cy_SPKR_diphone_0931	"sil @ xx ng uy d ay sil"	("ng-uy") )
( INST_cy_SPKR_diphone_0932	"sil @ xx ng yu d ay sil"	("ng-yu") )
( INST_cy_SPKR_diphone_0933	"sil @ xx ng ay d ay sil"	("ng-ay") )
( INST_cy_SPKR_diphone_0934	"sil @ xx ng aay d ay sil"	("ng-aay") )
( INST_cy_SPKR_diphone_0935	"sil @ xx ng ey d ay sil"	("ng-ey") )
( INST_cy_SPKR_diphone_0936	"sil @ xx ng oy d ay sil"	("ng-oy") )
( INST_cy_SPKR_diphone_0937	"sil @ xx rh i d ay sil"	("rh-i") )
( INST_cy_SPKR_diphone_0938	"sil @ xx rh e d ay sil"	("rh-e") )
( INST_cy_SPKR_diphone_0939	"sil @ xx rh a d ay sil"	("rh-a") )
( INST_cy_SPKR_diphone_0940	"sil @ xx rh o d ay sil"	("rh-o") )
( INST_cy_SPKR_diphone_0941	"sil @ xx rh u d ay sil"	("rh-u") )
( INST_cy_SPKR_diphone_0942	"sil @ xx rh y d ay sil"	("rh-y") )
( INST_cy_SPKR_diphone_0943	"sil @ xx rh @ d ay sil"	("rh-@") )
( INST_cy_SPKR_diphone_0944	"sil @ xx rh ii d ay sil"	("rh-ii") )
( INST_cy_SPKR_diphone_0945	"sil @ xx rh ee d ay sil"	("rh-ee") )
( INST_cy_SPKR_diphone_0946	"sil @ xx rh aa d ay sil"	("rh-aa") )
( INST_cy_SPKR_diphone_0947	"sil @ xx rh oo d ay sil"	("rh-oo") )
( INST_cy_SPKR_diphone_0948	"sil @ xx rh uu d ay sil"	("rh-uu") )
( INST_cy_SPKR_diphone_0949	"sil @ xx rh yy d ay sil"	("rh-yy") )
( INST_cy_SPKR_diphone_0950	"sil @ xx rh ei d ay sil"	("rh-ei") )
( INST_cy_SPKR_diphone_0951	"sil @ xx rh ai d ay sil"	("rh-ai") )
( INST_cy_SPKR_diphone_0952	"sil @ xx rh oi d ay sil"	("rh-oi") )
( INST_cy_SPKR_diphone_0953	"sil @ xx rh iu d ay sil"	("rh-iu") )
( INST_cy_SPKR_diphone_0954	"sil @ xx rh eu d ay sil"	("rh-eu") )
( INST_cy_SPKR_diphone_0955	"sil @ xx rh au d ay sil"	("rh-au") )
( INST_cy_SPKR_diphone_0956	"sil @ xx rh ou d ay sil"	("rh-ou") )
( INST_cy_SPKR_diphone_0957	"sil @ xx rh uy d ay sil"	("rh-uy") )
( INST_cy_SPKR_diphone_0958	"sil @ xx rh yu d ay sil"	("rh-yu") )
( INST_cy_SPKR_diphone_0959	"sil @ xx rh ay d ay sil"	("rh-ay") )
( INST_cy_SPKR_diphone_0960	"sil @ xx rh aay d ay sil"	("rh-aay") )
( INST_cy_SPKR_diphone_0961	"sil @ xx rh ey d ay sil"	("rh-ey") )
( INST_cy_SPKR_diphone_0962	"sil @ xx rh oy d ay sil"	("rh-oy") )
( INST_cy_SPKR_diphone_0963	"sil @ xx lw i d ay sil"	("lw-i") )
( INST_cy_SPKR_diphone_0964	"sil @ xx lw e d ay sil"	("lw-e") )
( INST_cy_SPKR_diphone_0965	"sil @ xx lw a d ay sil"	("lw-a") )
( INST_cy_SPKR_diphone_0966	"sil @ xx lw o d ay sil"	("lw-o") )
( INST_cy_SPKR_diphone_0967	"sil @ xx lw u d ay sil"	("lw-u") )
( INST_cy_SPKR_diphone_0968	"sil @ xx lw y d ay sil"	("lw-y") )
( INST_cy_SPKR_diphone_0969	"sil @ xx lw @ d ay sil"	("lw-@") )
( INST_cy_SPKR_diphone_0970	"sil @ xx lw ii d ay sil"	("lw-ii") )
( INST_cy_SPKR_diphone_0971	"sil @ xx lw ee d ay sil"	("lw-ee") )
( INST_cy_SPKR_diphone_0972	"sil @ xx lw aa d ay sil"	("lw-aa") )
( INST_cy_SPKR_diphone_0973	"sil @ xx lw oo d ay sil"	("lw-oo") )
( INST_cy_SPKR_diphone_0974	"sil @ xx lw uu d ay sil"	("lw-uu") )
( INST_cy_SPKR_diphone_0975	"sil @ xx lw yy d ay sil"	("lw-yy") )
( INST_cy_SPKR_diphone_0976	"sil @ xx lw ei d ay sil"	("lw-ei") )
( INST_cy_SPKR_diphone_0977	"sil @ xx lw ai d ay sil"	("lw-ai") )
( INST_cy_SPKR_diphone_0978	"sil @ xx lw oi d ay sil"	("lw-oi") )
( INST_cy_SPKR_diphone_0979	"sil @ xx lw iu d ay sil"	("lw-iu") )
( INST_cy_SPKR_diphone_0980	"sil @ xx lw eu d ay sil"	("lw-eu") )
( INST_cy_SPKR_diphone_0981	"sil @ xx lw au d ay sil"	("lw-au") )
( INST_cy_SPKR_diphone_0982	"sil @ xx lw ou d ay sil"	("lw-ou") )
( INST_cy_SPKR_diphone_0983	"sil @ xx lw uy d ay sil"	("lw-uy") )
( INST_cy_SPKR_diphone_0984	"sil @ xx lw yu d ay sil"	("lw-yu") )
( INST_cy_SPKR_diphone_0985	"sil @ xx lw ay d ay sil"	("lw-ay") )
( INST_cy_SPKR_diphone_0986	"sil @ xx lw aay d ay sil"	("lw-aay") )
( INST_cy_SPKR_diphone_0987	"sil @ xx lw ey d ay sil"	("lw-ey") )
( INST_cy_SPKR_diphone_0988	"sil @ xx lw oy d ay sil"	("lw-oy") )
( INST_cy_SPKR_diphone_0989	"sil @ xx nw i d ay sil"	("nw-i") )
( INST_cy_SPKR_diphone_0990	"sil @ xx nw e d ay sil"	("nw-e") )
( INST_cy_SPKR_diphone_0991	"sil @ xx nw a d ay sil"	("nw-a") )
( INST_cy_SPKR_diphone_0992	"sil @ xx nw o d ay sil"	("nw-o") )
( INST_cy_SPKR_diphone_0993	"sil @ xx nw u d ay sil"	("nw-u") )
( INST_cy_SPKR_diphone_0994	"sil @ xx nw y d ay sil"	("nw-y") )
( INST_cy_SPKR_diphone_0995	"sil @ xx nw @ d ay sil"	("nw-@") )
( INST_cy_SPKR_diphone_0996	"sil @ xx nw ii d ay sil"	("nw-ii") )
( INST_cy_SPKR_diphone_0997	"sil @ xx nw ee d ay sil"	("nw-ee") )
( INST_cy_SPKR_diphone_0998	"sil @ xx nw aa d ay sil"	("nw-aa") )
( INST_cy_SPKR_diphone_0999	"sil @ xx nw oo d ay sil"	("nw-oo") )
( INST_cy_SPKR_diphone_1000	"sil @ xx nw uu d ay sil"	("nw-uu") )
( INST_cy_SPKR_diphone_1001	"sil @ xx nw yy d ay sil"	("nw-yy") )
( INST_cy_SPKR_diphone_1002	"sil @ xx nw ei d ay sil"	("nw-ei") )
( INST_cy_SPKR_diphone_1003	"sil @ xx nw ai d ay sil"	("nw-ai") )
( INST_cy_SPKR_diphone_1004	"sil @ xx nw oi d ay sil"	("nw-oi") )
( INST_cy_SPKR_diphone_1005	"sil @ xx nw iu d ay sil"	("nw-iu") )
( INST_cy_SPKR_diphone_1006	"sil @ xx nw eu d ay sil"	("nw-eu") )
( INST_cy_SPKR_diphone_1007	"sil @ xx nw au d ay sil"	("nw-au") )
( INST_cy_SPKR_diphone_1008	"sil @ xx nw ou d ay sil"	("nw-ou") )
( INST_cy_SPKR_diphone_1009	"sil @ xx nw uy d ay sil"	("nw-uy") )
( INST_cy_SPKR_diphone_1010	"sil @ xx nw yu d ay sil"	("nw-yu") )
( INST_cy_SPKR_diphone_1011	"sil @ xx nw ay d ay sil"	("nw-ay") )
( INST_cy_SPKR_diphone_1012	"sil @ xx nw aay d ay sil"	("nw-aay") )
( INST_cy_SPKR_diphone_1013	"sil @ xx nw ey d ay sil"	("nw-ey") )
( INST_cy_SPKR_diphone_1014	"sil @ xx nw oy d ay sil"	("nw-oy") )
( INST_cy_SPKR_diphone_1015	"sil @ xx rw i d ay sil"	("rw-i") )
( INST_cy_SPKR_diphone_1016	"sil @ xx rw e d ay sil"	("rw-e") )
( INST_cy_SPKR_diphone_1017	"sil @ xx rw a d ay sil"	("rw-a") )
( INST_cy_SPKR_diphone_1018	"sil @ xx rw o d ay sil"	("rw-o") )
( INST_cy_SPKR_diphone_1019	"sil @ xx rw u d ay sil"	("rw-u") )
( INST_cy_SPKR_diphone_1020	"sil @ xx rw y d ay sil"	("rw-y") )
( INST_cy_SPKR_diphone_1021	"sil @ xx rw @ d ay sil"	("rw-@") )
( INST_cy_SPKR_diphone_1022	"sil @ xx rw ii d ay sil"	("rw-ii") )
( INST_cy_SPKR_diphone_1023	"sil @ xx rw ee d ay sil"	("rw-ee") )
( INST_cy_SPKR_diphone_1024	"sil @ xx rw aa d ay sil"	("rw-aa") )
( INST_cy_SPKR_diphone_1025	"sil @ xx rw oo d ay sil"	("rw-oo") )
( INST_cy_SPKR_diphone_1026	"sil @ xx rw uu d ay sil"	("rw-uu") )
( INST_cy_SPKR_diphone_1027	"sil @ xx rw yy d ay sil"	("rw-yy") )
( INST_cy_SPKR_diphone_1028	"sil @ xx rw ei d ay sil"	("rw-ei") )
( INST_cy_SPKR_diphone_1029	"sil @ xx rw ai d ay sil"	("rw-ai") )
( INST_cy_SPKR_diphone_1030	"sil @ xx rw oi d ay sil"	("rw-oi") )
( INST_cy_SPKR_diphone_1031	"sil @ xx rw iu d ay sil"	("rw-iu") )
( INST_cy_SPKR_diphone_1032	"sil @ xx rw eu d ay sil"	("rw-eu") )
( INST_cy_SPKR_diphone_1033	"sil @ xx rw au d ay sil"	("rw-au") )
( INST_cy_SPKR_diphone_1034	"sil @ xx rw ou d ay sil"	("rw-ou") )
( INST_cy_SPKR_diphone_1035	"sil @ xx rw uy d ay sil"	("rw-uy") )
( INST_cy_SPKR_diphone_1036	"sil @ xx rw yu d ay sil"	("rw-yu") )
( INST_cy_SPKR_diphone_1037	"sil @ xx rw ay d ay sil"	("rw-ay") )
( INST_cy_SPKR_diphone_1038	"sil @ xx rw aay d ay sil"	("rw-aay") )
( INST_cy_SPKR_diphone_1039	"sil @ xx rw ey d ay sil"	("rw-ey") )
( INST_cy_SPKR_diphone_1040	"sil @ xx rw oy d ay sil"	("rw-oy") )
( INST_cy_SPKR_diphone_1041	"sil @ xx w i d ay sil"	("w-i") )
( INST_cy_SPKR_diphone_1042	"sil @ xx w e d ay sil"	("w-e") )
( INST_cy_SPKR_diphone_1043	"sil @ xx w a d ay sil"	("w-a") )
( INST_cy_SPKR_diphone_1044	"sil @ xx w o d ay sil"	("w-o") )
( INST_cy_SPKR_diphone_1045	"sil @ xx w u d ay sil"	("w-u") )
( INST_cy_SPKR_diphone_1046	"sil @ xx w y d ay sil"	("w-y") )
( INST_cy_SPKR_diphone_1047	"sil @ xx w @ d ay sil"	("w-@") )
( INST_cy_SPKR_diphone_1048	"sil @ xx w ii d ay sil"	("w-ii") )
( INST_cy_SPKR_diphone_1049	"sil @ xx w ee d ay sil"	("w-ee") )
( INST_cy_SPKR_diphone_1050	"sil @ xx w aa d ay sil"	("w-aa") )
( INST_cy_SPKR_diphone_1051	"sil @ xx w oo d ay sil"	("w-oo") )
( INST_cy_SPKR_diphone_1052	"sil @ xx w uu d ay sil"	("w-uu") )
( INST_cy_SPKR_diphone_1053	"sil @ xx w yy d ay sil"	("w-yy") )
( INST_cy_SPKR_diphone_1054	"sil @ xx w ei d ay sil"	("w-ei") )
( INST_cy_SPKR_diphone_1055	"sil @ xx w ai d ay sil"	("w-ai") )
( INST_cy_SPKR_diphone_1056	"sil @ xx w oi d ay sil"	("w-oi") )
( INST_cy_SPKR_diphone_1057	"sil @ xx w iu d ay sil"	("w-iu") )
( INST_cy_SPKR_diphone_1058	"sil @ xx w eu d ay sil"	("w-eu") )
( INST_cy_SPKR_diphone_1059	"sil @ xx w au d ay sil"	("w-au") )
( INST_cy_SPKR_diphone_1060	"sil @ xx w ou d ay sil"	("w-ou") )
( INST_cy_SPKR_diphone_1061	"sil @ xx w uy d ay sil"	("w-uy") )
( INST_cy_SPKR_diphone_1062	"sil @ xx w yu d ay sil"	("w-yu") )
( INST_cy_SPKR_diphone_1063	"sil @ xx w ay d ay sil"	("w-ay") )
( INST_cy_SPKR_diphone_1064	"sil @ xx w aay d ay sil"	("w-aay") )
( INST_cy_SPKR_diphone_1065	"sil @ xx w ey d ay sil"	("w-ey") )
( INST_cy_SPKR_diphone_1066	"sil @ xx w oy d ay sil"	("w-oy") )
( INST_cy_SPKR_diphone_1067	"sil @ xx j e d ay sil"	("j-e") )
( INST_cy_SPKR_diphone_1068	"sil @ xx j a d ay sil"	("j-a") )
( INST_cy_SPKR_diphone_1069	"sil @ xx j o d ay sil"	("j-o") )
( INST_cy_SPKR_diphone_1070	"sil @ xx j ee d ay sil"	("j-ee") )
( INST_cy_SPKR_diphone_1071	"sil @ xx j aa d ay sil"	("j-aa") )
( INST_cy_SPKR_diphone_1072	"sil @ xx j oo d ay sil"	("j-oo") )
( INST_cy_SPKR_diphone_1073	"sil @ xx j ei d ay sil"	("j-ei") )
( INST_cy_SPKR_diphone_1074	"sil @ xx j ai d ay sil"	("j-ai") )
( INST_cy_SPKR_diphone_1075	"sil @ xx j oi d ay sil"	("j-oi") )
( INST_cy_SPKR_diphone_1076	"sil @ xx j eu d ay sil"	("j-eu") )
( INST_cy_SPKR_diphone_1077	"sil @ xx j au d ay sil"	("j-au") )
( INST_cy_SPKR_diphone_1078	"sil @ xx j ou d ay sil"	("j-ou") )
( INST_cy_SPKR_diphone_1079	"sil @ xx j ay d ay sil"	("j-ay") )
( INST_cy_SPKR_diphone_1080	"sil @ xx j aay d ay sil"	("j-aay") )
( INST_cy_SPKR_diphone_1081	"sil @ xx j ey d ay sil"	("j-ey") )
( INST_cy_SPKR_diphone_1082	"sil @ xx j oy d ay sil"	("j-oy") )
( INST_cy_SPKR_diphone_1083	"sil d @ d i xx i t sil"	("i-i") )
( INST_cy_SPKR_diphone_1084	"sil d @ d i xx e t sil"	("i-e") )
( INST_cy_SPKR_diphone_1085	"sil d @ d i xx a t sil"	("i-a") )
( INST_cy_SPKR_diphone_1086	"sil d @ d i xx o t sil"	("i-o") )
( INST_cy_SPKR_diphone_1087	"sil d @ d i xx u t sil"	("i-u") )
( INST_cy_SPKR_diphone_1088	"sil d @ d i xx y t sil"	("i-y") )
( INST_cy_SPKR_diphone_1089	"sil d @ d e xx i t sil"	("e-i") )
( INST_cy_SPKR_diphone_1090	"sil d @ d e xx e t sil"	("e-e") )
( INST_cy_SPKR_diphone_1091	"sil d @ d e xx a t sil"	("e-a") )
( INST_cy_SPKR_diphone_1092	"sil d @ d e xx o t sil"	("e-o") )
( INST_cy_SPKR_diphone_1093	"sil d @ d e xx u t sil"	("e-u") )
( INST_cy_SPKR_diphone_1094	"sil d @ d e xx y t sil"	("e-y") )
( INST_cy_SPKR_diphone_1095	"sil d @ d a xx i t sil"	("a-i") )
( INST_cy_SPKR_diphone_1096	"sil d @ d a xx e t sil"	("a-e") )
( INST_cy_SPKR_diphone_1097	"sil d @ d a xx a t sil"	("a-a") )
( INST_cy_SPKR_diphone_1098	"sil d @ d a xx o t sil"	("a-o") )
( INST_cy_SPKR_diphone_1099	"sil d @ d a xx u t sil"	("a-u") )
( INST_cy_SPKR_diphone_1100	"sil d @ d a xx y t sil"	("a-y") )
( INST_cy_SPKR_diphone_1101	"sil d @ d o xx i t sil"	("o-i") )
( INST_cy_SPKR_diphone_1102	"sil d @ d o xx e t sil"	("o-e") )
( INST_cy_SPKR_diphone_1103	"sil d @ d o xx a t sil"	("o-a") )
( INST_cy_SPKR_diphone_1104	"sil d @ d o xx o t sil"	("o-o") )
( INST_cy_SPKR_diphone_1105	"sil d @ d o xx u t sil"	("o-u") )
( INST_cy_SPKR_diphone_1106	"sil d @ d o xx y t sil"	("o-y") )
( INST_cy_SPKR_diphone_1107	"sil d @ d u xx i t sil"	("u-i") )
( INST_cy_SPKR_diphone_1108	"sil d @ d u xx e t sil"	("u-e") )
( INST_cy_SPKR_diphone_1109	"sil d @ d u xx a t sil"	("u-a") )
( INST_cy_SPKR_diphone_1110	"sil d @ d u xx o t sil"	("u-o") )
( INST_cy_SPKR_diphone_1111	"sil d @ d u xx u t sil"	("u-u") )
( INST_cy_SPKR_diphone_1112	"sil d @ d u xx y t sil"	("u-y") )
( INST_cy_SPKR_diphone_1113	"sil d @ d y xx i t sil"	("y-i") )
( INST_cy_SPKR_diphone_1114	"sil d @ d y xx e t sil"	("y-e") )
( INST_cy_SPKR_diphone_1115	"sil d @ d y xx a t sil"	("y-a") )
( INST_cy_SPKR_diphone_1116	"sil d @ d y xx o t sil"	("y-o") )
( INST_cy_SPKR_diphone_1117	"sil d @ d y xx u t sil"	("y-u") )
( INST_cy_SPKR_diphone_1118	"sil d @ d y xx y t sil"	("y-y") )
( INST_cy_SPKR_diphone_1119	"sil d @ d i xx @ d y sil"	("i-@") )
( INST_cy_SPKR_diphone_1120	"sil d @ d e xx @ d y sil"	("e-@") )
( INST_cy_SPKR_diphone_1121	"sil d @ d a xx @ d y sil"	("a-@") )
( INST_cy_SPKR_diphone_1122	"sil d @ d o xx @ d y sil"	("o-@") )
( INST_cy_SPKR_diphone_1123	"sil d @ d u xx @ d y sil"	("u-@") )
( INST_cy_SPKR_diphone_1124	"sil d @ d y xx @ d y sil"	("y-@") )
( INST_cy_SPKR_diphone_1125	"sil d @ d i xx ii d sil"	("i-ii") )
( INST_cy_SPKR_diphone_1126	"sil d @ d i xx ee d sil"	("i-ee") )
( INST_cy_SPKR_diphone_1127	"sil d @ d i xx aa d sil"	("i-aa") )
( INST_cy_SPKR_diphone_1128	"sil d @ d i xx oo d sil"	("i-oo") )
( INST_cy_SPKR_diphone_1129	"sil d @ d i xx uu d sil"	("i-uu") )
( INST_cy_SPKR_diphone_1130	"sil d @ d i xx yy d sil"	("i-yy") )
( INST_cy_SPKR_diphone_1131	"sil d @ d i xx ei d sil"	("i-ei") )
( INST_cy_SPKR_diphone_1132	"sil d @ d i xx ai d sil"	("i-ai") )
( INST_cy_SPKR_diphone_1133	"sil d @ d i xx oi d sil"	("i-oi") )
( INST_cy_SPKR_diphone_1134	"sil d @ d i xx iu d sil"	("i-iu") )
( INST_cy_SPKR_diphone_1135	"sil d @ d i xx eu d sil"	("i-eu") )
( INST_cy_SPKR_diphone_1136	"sil d @ d i xx au d sil"	("i-au") )
( INST_cy_SPKR_diphone_1137	"sil d @ d i xx ou d sil"	("i-ou") )
( INST_cy_SPKR_diphone_1138	"sil d @ d i xx uy d sil"	("i-uy") )
( INST_cy_SPKR_diphone_1139	"sil d @ d i xx yu d sil"	("i-yu") )
( INST_cy_SPKR_diphone_1140	"sil d @ d i xx ay d sil"	("i-ay") )
( INST_cy_SPKR_diphone_1141	"sil d @ d i xx aay d sil"	("i-aay") )
( INST_cy_SPKR_diphone_1142	"sil d @ d i xx ey d sil"	("i-ey") )
( INST_cy_SPKR_diphone_1143	"sil d @ d i xx oy d sil"	("i-oy") )
( INST_cy_SPKR_diphone_1144	"sil d @ d e xx ii d sil"	("e-ii") )
( INST_cy_SPKR_diphone_1145	"sil d @ d e xx ee d sil"	("e-ee") )
( INST_cy_SPKR_diphone_1146	"sil d @ d e xx aa d sil"	("e-aa") )
( INST_cy_SPKR_diphone_1147	"sil d @ d e xx oo d sil"	("e-oo") )
( INST_cy_SPKR_diphone_1148	"sil d @ d e xx uu d sil"	("e-uu") )
( INST_cy_SPKR_diphone_1149	"sil d @ d e xx yy d sil"	("e-yy") )
( INST_cy_SPKR_diphone_1150	"sil d @ d e xx ei d sil"	("e-ei") )
( INST_cy_SPKR_diphone_1151	"sil d @ d e xx ai d sil"	("e-ai") )
( INST_cy_SPKR_diphone_1152	"sil d @ d e xx oi d sil"	("e-oi") )
( INST_cy_SPKR_diphone_1153	"sil d @ d e xx iu d sil"	("e-iu") )
( INST_cy_SPKR_diphone_1154	"sil d @ d e xx eu d sil"	("e-eu") )
( INST_cy_SPKR_diphone_1155	"sil d @ d e xx au d sil"	("e-au") )
( INST_cy_SPKR_diphone_1156	"sil d @ d e xx ou d sil"	("e-ou") )
( INST_cy_SPKR_diphone_1157	"sil d @ d e xx uy d sil"	("e-uy") )
( INST_cy_SPKR_diphone_1158	"sil d @ d e xx yu d sil"	("e-yu") )
( INST_cy_SPKR_diphone_1159	"sil d @ d e xx ay d sil"	("e-ay") )
( INST_cy_SPKR_diphone_1160	"sil d @ d e xx aay d sil"	("e-aay") )
( INST_cy_SPKR_diphone_1161	"sil d @ d e xx ey d sil"	("e-ey") )
( INST_cy_SPKR_diphone_1162	"sil d @ d e xx oy d sil"	("e-oy") )
( INST_cy_SPKR_diphone_1163	"sil d @ d a xx ii d sil"	("a-ii") )
( INST_cy_SPKR_diphone_1164	"sil d @ d a xx ee d sil"	("a-ee") )
( INST_cy_SPKR_diphone_1165	"sil d @ d a xx aa d sil"	("a-aa") )
( INST_cy_SPKR_diphone_1166	"sil d @ d a xx oo d sil"	("a-oo") )
( INST_cy_SPKR_diphone_1167	"sil d @ d a xx uu d sil"	("a-uu") )
( INST_cy_SPKR_diphone_1168	"sil d @ d a xx yy d sil"	("a-yy") )
( INST_cy_SPKR_diphone_1169	"sil d @ d a xx ei d sil"	("a-ei") )
( INST_cy_SPKR_diphone_1170	"sil d @ d a xx ai d sil"	("a-ai") )
( INST_cy_SPKR_diphone_1171	"sil d @ d a xx oi d sil"	("a-oi") )
( INST_cy_SPKR_diphone_1172	"sil d @ d a xx iu d sil"	("a-iu") )
( INST_cy_SPKR_diphone_1173	"sil d @ d a xx eu d sil"	("a-eu") )
( INST_cy_SPKR_diphone_1174	"sil d @ d a xx au d sil"	("a-au") )
( INST_cy_SPKR_diphone_1175	"sil d @ d a xx ou d sil"	("a-ou") )
( INST_cy_SPKR_diphone_1176	"sil d @ d a xx uy d sil"	("a-uy") )
( INST_cy_SPKR_diphone_1177	"sil d @ d a xx yu d sil"	("a-yu") )
( INST_cy_SPKR_diphone_1178	"sil d @ d a xx ay d sil"	("a-ay") )
( INST_cy_SPKR_diphone_1179	"sil d @ d a xx aay d sil"	("a-aay") )
( INST_cy_SPKR_diphone_1180	"sil d @ d a xx ey d sil"	("a-ey") )
( INST_cy_SPKR_diphone_1181	"sil d @ d a xx oy d sil"	("a-oy") )
( INST_cy_SPKR_diphone_1182	"sil d @ d o xx ii d sil"	("o-ii") )
( INST_cy_SPKR_diphone_1183	"sil d @ d o xx ee d sil"	("o-ee") )
( INST_cy_SPKR_diphone_1184	"sil d @ d o xx aa d sil"	("o-aa") )
( INST_cy_SPKR_diphone_1185	"sil d @ d o xx oo d sil"	("o-oo") )
( INST_cy_SPKR_diphone_1186	"sil d @ d o xx uu d sil"	("o-uu") )
( INST_cy_SPKR_diphone_1187	"sil d @ d o xx yy d sil"	("o-yy") )
( INST_cy_SPKR_diphone_1188	"sil d @ d o xx ei d sil"	("o-ei") )
( INST_cy_SPKR_diphone_1189	"sil d @ d o xx ai d sil"	("o-ai") )
( INST_cy_SPKR_diphone_1190	"sil d @ d o xx oi d sil"	("o-oi") )
( INST_cy_SPKR_diphone_1191	"sil d @ d o xx iu d sil"	("o-iu") )
( INST_cy_SPKR_diphone_1192	"sil d @ d o xx eu d sil"	("o-eu") )
( INST_cy_SPKR_diphone_1193	"sil d @ d o xx au d sil"	("o-au") )
( INST_cy_SPKR_diphone_1194	"sil d @ d o xx ou d sil"	("o-ou") )
( INST_cy_SPKR_diphone_1195	"sil d @ d o xx uy d sil"	("o-uy") )
( INST_cy_SPKR_diphone_1196	"sil d @ d o xx yu d sil"	("o-yu") )
( INST_cy_SPKR_diphone_1197	"sil d @ d o xx ay d sil"	("o-ay") )
( INST_cy_SPKR_diphone_1198	"sil d @ d o xx aay d sil"	("o-aay") )
( INST_cy_SPKR_diphone_1199	"sil d @ d o xx ey d sil"	("o-ey") )
( INST_cy_SPKR_diphone_1200	"sil d @ d o xx oy d sil"	("o-oy") )
( INST_cy_SPKR_diphone_1201	"sil d @ d u xx ii d sil"	("u-ii") )
( INST_cy_SPKR_diphone_1202	"sil d @ d u xx ee d sil"	("u-ee") )
( INST_cy_SPKR_diphone_1203	"sil d @ d u xx aa d sil"	("u-aa") )
( INST_cy_SPKR_diphone_1204	"sil d @ d u xx oo d sil"	("u-oo") )
( INST_cy_SPKR_diphone_1205	"sil d @ d u xx uu d sil"	("u-uu") )
( INST_cy_SPKR_diphone_1206	"sil d @ d u xx yy d sil"	("u-yy") )
( INST_cy_SPKR_diphone_1207	"sil d @ d u xx ei d sil"	("u-ei") )
( INST_cy_SPKR_diphone_1208	"sil d @ d u xx ai d sil"	("u-ai") )
( INST_cy_SPKR_diphone_1209	"sil d @ d u xx oi d sil"	("u-oi") )
( INST_cy_SPKR_diphone_1210	"sil d @ d u xx iu d sil"	("u-iu") )
( INST_cy_SPKR_diphone_1211	"sil d @ d u xx eu d sil"	("u-eu") )
( INST_cy_SPKR_diphone_1212	"sil d @ d u xx au d sil"	("u-au") )
( INST_cy_SPKR_diphone_1213	"sil d @ d u xx ou d sil"	("u-ou") )
( INST_cy_SPKR_diphone_1214	"sil d @ d u xx uy d sil"	("u-uy") )
( INST_cy_SPKR_diphone_1215	"sil d @ d u xx yu d sil"	("u-yu") )
( INST_cy_SPKR_diphone_1216	"sil d @ d u xx ay d sil"	("u-ay") )
( INST_cy_SPKR_diphone_1217	"sil d @ d u xx aay d sil"	("u-aay") )
( INST_cy_SPKR_diphone_1218	"sil d @ d u xx ey d sil"	("u-ey") )
( INST_cy_SPKR_diphone_1219	"sil d @ d u xx oy d sil"	("u-oy") )
( INST_cy_SPKR_diphone_1220	"sil d @ d y xx ii d sil"	("y-ii") )
( INST_cy_SPKR_diphone_1221	"sil d @ d y xx ee d sil"	("y-ee") )
( INST_cy_SPKR_diphone_1222	"sil d @ d y xx aa d sil"	("y-aa") )
( INST_cy_SPKR_diphone_1223	"sil d @ d y xx oo d sil"	("y-oo") )
( INST_cy_SPKR_diphone_1224	"sil d @ d y xx uu d sil"	("y-uu") )
( INST_cy_SPKR_diphone_1225	"sil d @ d y xx yy d sil"	("y-yy") )
( INST_cy_SPKR_diphone_1226	"sil d @ d y xx ei d sil"	("y-ei") )
( INST_cy_SPKR_diphone_1227	"sil d @ d y xx ai d sil"	("y-ai") )
( INST_cy_SPKR_diphone_1228	"sil d @ d y xx oi d sil"	("y-oi") )
( INST_cy_SPKR_diphone_1229	"sil d @ d y xx iu d sil"	("y-iu") )
( INST_cy_SPKR_diphone_1230	"sil d @ d y xx eu d sil"	("y-eu") )
( INST_cy_SPKR_diphone_1231	"sil d @ d y xx au d sil"	("y-au") )
( INST_cy_SPKR_diphone_1232	"sil d @ d y xx ou d sil"	("y-ou") )
( INST_cy_SPKR_diphone_1233	"sil d @ d y xx uy d sil"	("y-uy") )
( INST_cy_SPKR_diphone_1234	"sil d @ d y xx yu d sil"	("y-yu") )
( INST_cy_SPKR_diphone_1235	"sil d @ d y xx ay d sil"	("y-ay") )
( INST_cy_SPKR_diphone_1236	"sil d @ d y xx aay d sil"	("y-aay") )
( INST_cy_SPKR_diphone_1237	"sil d @ d y xx ey d sil"	("y-ey") )
( INST_cy_SPKR_diphone_1238	"sil d @ d y xx oy d sil"	("y-oy") )
( INST_cy_SPKR_diphone_1239	"sil d @ xx i t sil"	("@-i") )
( INST_cy_SPKR_diphone_1240	"sil d @ xx e t sil"	("@-e") )
( INST_cy_SPKR_diphone_1241	"sil d @ xx a t sil"	("@-a") )
( INST_cy_SPKR_diphone_1242	"sil d @ xx o t sil"	("@-o") )
( INST_cy_SPKR_diphone_1243	"sil d @ xx u t sil"	("@-u") )
( INST_cy_SPKR_diphone_1244	"sil d @ xx y t sil"	("@-y") )
( INST_cy_SPKR_diphone_1245	"sil d @ xx @ d y sil"	("@-@") )
( INST_cy_SPKR_diphone_1246	"sil d @ xx ii d sil"	("@-ii") )
( INST_cy_SPKR_diphone_1247	"sil d @ xx ee d sil"	("@-ee") )
( INST_cy_SPKR_diphone_1248	"sil d @ xx aa d sil"	("@-aa") )
( INST_cy_SPKR_diphone_1249	"sil d @ xx oo d sil"	("@-oo") )
( INST_cy_SPKR_diphone_1250	"sil d @ xx uu d sil"	("@-uu") )
( INST_cy_SPKR_diphone_1251	"sil d @ xx yy d sil"	("@-yy") )
( INST_cy_SPKR_diphone_1252	"sil d @ xx ei d sil"	("@-ei") )
( INST_cy_SPKR_diphone_1253	"sil d @ xx ai d sil"	("@-ai") )
( INST_cy_SPKR_diphone_1254	"sil d @ xx oi d sil"	("@-oi") )
( INST_cy_SPKR_diphone_1255	"sil d @ xx iu d sil"	("@-iu") )
( INST_cy_SPKR_diphone_1256	"sil d @ xx eu d sil"	("@-eu") )
( INST_cy_SPKR_diphone_1257	"sil d @ xx au d sil"	("@-au") )
( INST_cy_SPKR_diphone_1258	"sil d @ xx ou d sil"	("@-ou") )
( INST_cy_SPKR_diphone_1259	"sil d @ xx uy d sil"	("@-uy") )
( INST_cy_SPKR_diphone_1260	"sil d @ xx yu d sil"	("@-yu") )
( INST_cy_SPKR_diphone_1261	"sil d @ xx ay d sil"	("@-ay") )
( INST_cy_SPKR_diphone_1262	"sil d @ xx aay d sil"	("@-aay") )
( INST_cy_SPKR_diphone_1263	"sil d @ xx ey d sil"	("@-ey") )
( INST_cy_SPKR_diphone_1264	"sil d @ xx oy d sil"	("@-oy") )
( INST_cy_SPKR_diphone_1265	"sil @ n xx d ii - i t sil"	("ii-i") )
( INST_cy_SPKR_diphone_1266	"sil @ n xx d ii - e t sil"	("ii-e") )
( INST_cy_SPKR_diphone_1267	"sil @ n xx d ii - a t sil"	("ii-a") )
( INST_cy_SPKR_diphone_1268	"sil @ n xx d ii - o t sil"	("ii-o") )
( INST_cy_SPKR_diphone_1269	"sil @ n xx d ii - u t sil"	("ii-u") )
( INST_cy_SPKR_diphone_1270	"sil @ n xx d ii - y t sil"	("ii-y") )
( INST_cy_SPKR_diphone_1271	"sil @ n xx d ee - i t sil"	("ee-i") )
( INST_cy_SPKR_diphone_1272	"sil @ n xx d ee - e t sil"	("ee-e") )
( INST_cy_SPKR_diphone_1273	"sil @ n xx d ee - a t sil"	("ee-a") )
( INST_cy_SPKR_diphone_1274	"sil @ n xx d ee - o t sil"	("ee-o") )
( INST_cy_SPKR_diphone_1275	"sil @ n xx d ee - u t sil"	("ee-u") )
( INST_cy_SPKR_diphone_1276	"sil @ n xx d ee - y t sil"	("ee-y") )
( INST_cy_SPKR_diphone_1277	"sil @ n xx d aa - i t sil"	("aa-i") )
( INST_cy_SPKR_diphone_1278	"sil @ n xx d aa - e t sil"	("aa-e") )
( INST_cy_SPKR_diphone_1279	"sil @ n xx d aa - a t sil"	("aa-a") )
( INST_cy_SPKR_diphone_1280	"sil @ n xx d aa - o t sil"	("aa-o") )
( INST_cy_SPKR_diphone_1281	"sil @ n xx d aa - u t sil"	("aa-u") )
( INST_cy_SPKR_diphone_1282	"sil @ n xx d aa - y t sil"	("aa-y") )
( INST_cy_SPKR_diphone_1283	"sil @ n xx d oo - i t sil"	("oo-i") )
( INST_cy_SPKR_diphone_1284	"sil @ n xx d oo - e t sil"	("oo-e") )
( INST_cy_SPKR_diphone_1285	"sil @ n xx d oo - a t sil"	("oo-a") )
( INST_cy_SPKR_diphone_1286	"sil @ n xx d oo - o t sil"	("oo-o") )
( INST_cy_SPKR_diphone_1287	"sil @ n xx d oo - u t sil"	("oo-u") )
( INST_cy_SPKR_diphone_1288	"sil @ n xx d oo - y t sil"	("oo-y") )
( INST_cy_SPKR_diphone_1289	"sil @ n xx d uu - i t sil"	("uu-i") )
( INST_cy_SPKR_diphone_1290	"sil @ n xx d uu - e t sil"	("uu-e") )
( INST_cy_SPKR_diphone_1291	"sil @ n xx d uu - a t sil"	("uu-a") )
( INST_cy_SPKR_diphone_1292	"sil @ n xx d uu - o t sil"	("uu-o") )
( INST_cy_SPKR_diphone_1293	"sil @ n xx d uu - u t sil"	("uu-u") )
( INST_cy_SPKR_diphone_1294	"sil @ n xx d uu - y t sil"	("uu-y") )
( INST_cy_SPKR_diphone_1295	"sil @ n xx d yy - i t sil"	("yy-i") )
( INST_cy_SPKR_diphone_1296	"sil @ n xx d yy - e t sil"	("yy-e") )
( INST_cy_SPKR_diphone_1297	"sil @ n xx d yy - a t sil"	("yy-a") )
( INST_cy_SPKR_diphone_1298	"sil @ n xx d yy - o t sil"	("yy-o") )
( INST_cy_SPKR_diphone_1299	"sil @ n xx d yy - u t sil"	("yy-u") )
( INST_cy_SPKR_diphone_1300	"sil @ n xx d yy - y t sil"	("yy-y") )
( INST_cy_SPKR_diphone_1301	"sil @ n xx d ei - i t sil"	("ei-i") )
( INST_cy_SPKR_diphone_1302	"sil @ n xx d ei - e t sil"	("ei-e") )
( INST_cy_SPKR_diphone_1303	"sil @ n xx d ei - a t sil"	("ei-a") )
( INST_cy_SPKR_diphone_1304	"sil @ n xx d ei - o t sil"	("ei-o") )
( INST_cy_SPKR_diphone_1305	"sil @ n xx d ei - u t sil"	("ei-u") )
( INST_cy_SPKR_diphone_1306	"sil @ n xx d ei - y t sil"	("ei-y") )
( INST_cy_SPKR_diphone_1307	"sil @ n xx d ai - i t sil"	("ai-i") )
( INST_cy_SPKR_diphone_1308	"sil @ n xx d ai - e t sil"	("ai-e") )
( INST_cy_SPKR_diphone_1309	"sil @ n xx d ai - a t sil"	("ai-a") )
( INST_cy_SPKR_diphone_1310	"sil @ n xx d ai - o t sil"	("ai-o") )
( INST_cy_SPKR_diphone_1311	"sil @ n xx d ai - u t sil"	("ai-u") )
( INST_cy_SPKR_diphone_1312	"sil @ n xx d ai - y t sil"	("ai-y") )
( INST_cy_SPKR_diphone_1313	"sil @ n xx d oi - i t sil"	("oi-i") )
( INST_cy_SPKR_diphone_1314	"sil @ n xx d oi - e t sil"	("oi-e") )
( INST_cy_SPKR_diphone_1315	"sil @ n xx d oi - a t sil"	("oi-a") )
( INST_cy_SPKR_diphone_1316	"sil @ n xx d oi - o t sil"	("oi-o") )
( INST_cy_SPKR_diphone_1317	"sil @ n xx d oi - u t sil"	("oi-u") )
( INST_cy_SPKR_diphone_1318	"sil @ n xx d oi - y t sil"	("oi-y") )
( INST_cy_SPKR_diphone_1319	"sil @ n xx d iu - i t sil"	("iu-i") )
( INST_cy_SPKR_diphone_1320	"sil @ n xx d iu - e t sil"	("iu-e") )
( INST_cy_SPKR_diphone_1321	"sil @ n xx d iu - a t sil"	("iu-a") )
( INST_cy_SPKR_diphone_1322	"sil @ n xx d iu - o t sil"	("iu-o") )
( INST_cy_SPKR_diphone_1323	"sil @ n xx d iu - u t sil"	("iu-u") )
( INST_cy_SPKR_diphone_1324	"sil @ n xx d iu - y t sil"	("iu-y") )
( INST_cy_SPKR_diphone_1325	"sil @ n xx d eu - i t sil"	("eu-i") )
( INST_cy_SPKR_diphone_1326	"sil @ n xx d eu - e t sil"	("eu-e") )
( INST_cy_SPKR_diphone_1327	"sil @ n xx d eu - a t sil"	("eu-a") )
( INST_cy_SPKR_diphone_1328	"sil @ n xx d eu - o t sil"	("eu-o") )
( INST_cy_SPKR_diphone_1329	"sil @ n xx d eu - u t sil"	("eu-u") )
( INST_cy_SPKR_diphone_1330	"sil @ n xx d eu - y t sil"	("eu-y") )
( INST_cy_SPKR_diphone_1331	"sil @ n xx d au - i t sil"	("au-i") )
( INST_cy_SPKR_diphone_1332	"sil @ n xx d au - e t sil"	("au-e") )
( INST_cy_SPKR_diphone_1333	"sil @ n xx d au - a t sil"	("au-a") )
( INST_cy_SPKR_diphone_1334	"sil @ n xx d au - o t sil"	("au-o") )
( INST_cy_SPKR_diphone_1335	"sil @ n xx d au - u t sil"	("au-u") )
( INST_cy_SPKR_diphone_1336	"sil @ n xx d au - y t sil"	("au-y") )
( INST_cy_SPKR_diphone_1337	"sil @ n xx d ou - i t sil"	("ou-i") )
( INST_cy_SPKR_diphone_1338	"sil @ n xx d ou - e t sil"	("ou-e") )
( INST_cy_SPKR_diphone_1339	"sil @ n xx d ou - a t sil"	("ou-a") )
( INST_cy_SPKR_diphone_1340	"sil @ n xx d ou - o t sil"	("ou-o") )
( INST_cy_SPKR_diphone_1341	"sil @ n xx d ou - u t sil"	("ou-u") )
( INST_cy_SPKR_diphone_1342	"sil @ n xx d ou - y t sil"	("ou-y") )
( INST_cy_SPKR_diphone_1343	"sil @ n xx d uy - i t sil"	("uy-i") )
( INST_cy_SPKR_diphone_1344	"sil @ n xx d uy - e t sil"	("uy-e") )
( INST_cy_SPKR_diphone_1345	"sil @ n xx d uy - a t sil"	("uy-a") )
( INST_cy_SPKR_diphone_1346	"sil @ n xx d uy - o t sil"	("uy-o") )
( INST_cy_SPKR_diphone_1347	"sil @ n xx d uy - u t sil"	("uy-u") )
( INST_cy_SPKR_diphone_1348	"sil @ n xx d uy - y t sil"	("uy-y") )
( INST_cy_SPKR_diphone_1349	"sil @ n xx d yu - i t sil"	("yu-i") )
( INST_cy_SPKR_diphone_1350	"sil @ n xx d yu - e t sil"	("yu-e") )
( INST_cy_SPKR_diphone_1351	"sil @ n xx d yu - a t sil"	("yu-a") )
( INST_cy_SPKR_diphone_1352	"sil @ n xx d yu - o t sil"	("yu-o") )
( INST_cy_SPKR_diphone_1353	"sil @ n xx d yu - u t sil"	("yu-u") )
( INST_cy_SPKR_diphone_1354	"sil @ n xx d yu - y t sil"	("yu-y") )
( INST_cy_SPKR_diphone_1355	"sil @ n xx d ay - i t sil"	("ay-i") )
( INST_cy_SPKR_diphone_1356	"sil @ n xx d ay - e t sil"	("ay-e") )
( INST_cy_SPKR_diphone_1357	"sil @ n xx d ay - a t sil"	("ay-a") )
( INST_cy_SPKR_diphone_1358	"sil @ n xx d ay - o t sil"	("ay-o") )
( INST_cy_SPKR_diphone_1359	"sil @ n xx d ay - u t sil"	("ay-u") )
( INST_cy_SPKR_diphone_1360	"sil @ n xx d ay - y t sil"	("ay-y") )
( INST_cy_SPKR_diphone_1361	"sil @ n xx d aay - i t sil"	("aay-i") )
( INST_cy_SPKR_diphone_1362	"sil @ n xx d aay - e t sil"	("aay-e") )
( INST_cy_SPKR_diphone_1363	"sil @ n xx d aay - a t sil"	("aay-a") )
( INST_cy_SPKR_diphone_1364	"sil @ n xx d aay - o t sil"	("aay-o") )
( INST_cy_SPKR_diphone_1365	"sil @ n xx d aay - u t sil"	("aay-u") )
( INST_cy_SPKR_diphone_1366	"sil @ n xx d aay - y t sil"	("aay-y") )
( INST_cy_SPKR_diphone_1367	"sil @ n xx d ey - i t sil"	("ey-i") )
( INST_cy_SPKR_diphone_1368	"sil @ n xx d ey - e t sil"	("ey-e") )
( INST_cy_SPKR_diphone_1369	"sil @ n xx d ey - a t sil"	("ey-a") )
( INST_cy_SPKR_diphone_1370	"sil @ n xx d ey - o t sil"	("ey-o") )
( INST_cy_SPKR_diphone_1371	"sil @ n xx d ey - u t sil"	("ey-u") )
( INST_cy_SPKR_diphone_1372	"sil @ n xx d ey - y t sil"	("ey-y") )
( INST_cy_SPKR_diphone_1373	"sil @ n xx d oy - i t sil"	("oy-i") )
( INST_cy_SPKR_diphone_1374	"sil @ n xx d oy - e t sil"	("oy-e") )
( INST_cy_SPKR_diphone_1375	"sil @ n xx d oy - a t sil"	("oy-a") )
( INST_cy_SPKR_diphone_1376	"sil @ n xx d oy - o t sil"	("oy-o") )
( INST_cy_SPKR_diphone_1377	"sil @ n xx d oy - u t sil"	("oy-u") )
( INST_cy_SPKR_diphone_1378	"sil @ n xx d oy - y t sil"	("oy-y") )
( INST_cy_SPKR_diphone_1379	"sil @ n xx d ii - @ d y sil"	("ii-@") )
( INST_cy_SPKR_diphone_1380	"sil @ n xx d ee - @ d y sil"	("ee-@") )
( INST_cy_SPKR_diphone_1381	"sil @ n xx d aa - @ d y sil"	("aa-@") )
( INST_cy_SPKR_diphone_1382	"sil @ n xx d oo - @ d y sil"	("oo-@") )
( INST_cy_SPKR_diphone_1383	"sil @ n xx d uu - @ d y sil"	("uu-@") )
( INST_cy_SPKR_diphone_1384	"sil @ n xx d yy - @ d y sil"	("yy-@") )
( INST_cy_SPKR_diphone_1385	"sil @ n xx d ei - @ d y sil"	("ei-@") )
( INST_cy_SPKR_diphone_1386	"sil @ n xx d ai - @ d y sil"	("ai-@") )
( INST_cy_SPKR_diphone_1387	"sil @ n xx d oi - @ d y sil"	("oi-@") )
( INST_cy_SPKR_diphone_1388	"sil @ n xx d iu - @ d y sil"	("iu-@") )
( INST_cy_SPKR_diphone_1389	"sil @ n xx d eu - @ d y sil"	("eu-@") )
( INST_cy_SPKR_diphone_1390	"sil @ n xx d au - @ d y sil"	("au-@") )
( INST_cy_SPKR_diphone_1391	"sil @ n xx d ou - @ d y sil"	("ou-@") )
( INST_cy_SPKR_diphone_1392	"sil @ n xx d uy - @ d y sil"	("uy-@") )
( INST_cy_SPKR_diphone_1393	"sil @ n xx d yu - @ d y sil"	("yu-@") )
( INST_cy_SPKR_diphone_1394	"sil @ n xx d ay - @ d y sil"	("ay-@") )
( INST_cy_SPKR_diphone_1395	"sil @ n xx d aay - @ d y sil"	("aay-@") )
( INST_cy_SPKR_diphone_1396	"sil @ n xx d ey - @ d y sil"	("ey-@") )
( INST_cy_SPKR_diphone_1397	"sil @ n xx d oy - @ d y sil"	("oy-@") )
( INST_cy_SPKR_diphone_1398	"sil @ n xx d ii - ii d sil"	("ii-ii") )
( INST_cy_SPKR_diphone_1399	"sil @ n xx d ii - ee d sil"	("ii-ee") )
( INST_cy_SPKR_diphone_1400	"sil @ n xx d ii - aa d sil"	("ii-aa") )
( INST_cy_SPKR_diphone_1401	"sil @ n xx d ii - oo d sil"	("ii-oo") )
( INST_cy_SPKR_diphone_1402	"sil @ n xx d ii - uu d sil"	("ii-uu") )
( INST_cy_SPKR_diphone_1403	"sil @ n xx d ii - yy d sil"	("ii-yy") )
( INST_cy_SPKR_diphone_1404	"sil @ n xx d ii - ei d sil"	("ii-ei") )
( INST_cy_SPKR_diphone_1405	"sil @ n xx d ii - ai d sil"	("ii-ai") )
( INST_cy_SPKR_diphone_1406	"sil @ n xx d ii - oi d sil"	("ii-oi") )
( INST_cy_SPKR_diphone_1407	"sil @ n xx d ii - iu d sil"	("ii-iu") )
( INST_cy_SPKR_diphone_1408	"sil @ n xx d ii - eu d sil"	("ii-eu") )
( INST_cy_SPKR_diphone_1409	"sil @ n xx d ii - au d sil"	("ii-au") )
( INST_cy_SPKR_diphone_1410	"sil @ n xx d ii - ou d sil"	("ii-ou") )
( INST_cy_SPKR_diphone_1411	"sil @ n xx d ii - uy d sil"	("ii-uy") )
( INST_cy_SPKR_diphone_1412	"sil @ n xx d ii - yu d sil"	("ii-yu") )
( INST_cy_SPKR_diphone_1413	"sil @ n xx d ii - ay d sil"	("ii-ay") )
( INST_cy_SPKR_diphone_1414	"sil @ n xx d ii - aay d sil"	("ii-aay") )
( INST_cy_SPKR_diphone_1415	"sil @ n xx d ii - ey d sil"	("ii-ey") )
( INST_cy_SPKR_diphone_1416	"sil @ n xx d ii - oy d sil"	("ii-oy") )
( INST_cy_SPKR_diphone_1417	"sil @ n xx d ee - ii d sil"	("ee-ii") )
( INST_cy_SPKR_diphone_1418	"sil @ n xx d ee - ee d sil"	("ee-ee") )
( INST_cy_SPKR_diphone_1419	"sil @ n xx d ee - aa d sil"	("ee-aa") )
( INST_cy_SPKR_diphone_1420	"sil @ n xx d ee - oo d sil"	("ee-oo") )
( INST_cy_SPKR_diphone_1421	"sil @ n xx d ee - uu d sil"	("ee-uu") )
( INST_cy_SPKR_diphone_1422	"sil @ n xx d ee - yy d sil"	("ee-yy") )
( INST_cy_SPKR_diphone_1423	"sil @ n xx d ee - ei d sil"	("ee-ei") )
( INST_cy_SPKR_diphone_1424	"sil @ n xx d ee - ai d sil"	("ee-ai") )
( INST_cy_SPKR_diphone_1425	"sil @ n xx d ee - oi d sil"	("ee-oi") )
( INST_cy_SPKR_diphone_1426	"sil @ n xx d ee - iu d sil"	("ee-iu") )
( INST_cy_SPKR_diphone_1427	"sil @ n xx d ee - eu d sil"	("ee-eu") )
( INST_cy_SPKR_diphone_1428	"sil @ n xx d ee - au d sil"	("ee-au") )
( INST_cy_SPKR_diphone_1429	"sil @ n xx d ee - ou d sil"	("ee-ou") )
( INST_cy_SPKR_diphone_1430	"sil @ n xx d ee - uy d sil"	("ee-uy") )
( INST_cy_SPKR_diphone_1431	"sil @ n xx d ee - yu d sil"	("ee-yu") )
( INST_cy_SPKR_diphone_1432	"sil @ n xx d ee - ay d sil"	("ee-ay") )
( INST_cy_SPKR_diphone_1433	"sil @ n xx d ee - aay d sil"	("ee-aay") )
( INST_cy_SPKR_diphone_1434	"sil @ n xx d ee - ey d sil"	("ee-ey") )
( INST_cy_SPKR_diphone_1435	"sil @ n xx d ee - oy d sil"	("ee-oy") )
( INST_cy_SPKR_diphone_1436	"sil @ n xx d aa - ii d sil"	("aa-ii") )
( INST_cy_SPKR_diphone_1437	"sil @ n xx d aa - ee d sil"	("aa-ee") )
( INST_cy_SPKR_diphone_1438	"sil @ n xx d aa - aa d sil"	("aa-aa") )
( INST_cy_SPKR_diphone_1439	"sil @ n xx d aa - oo d sil"	("aa-oo") )
( INST_cy_SPKR_diphone_1440	"sil @ n xx d aa - uu d sil"	("aa-uu") )
( INST_cy_SPKR_diphone_1441	"sil @ n xx d aa - yy d sil"	("aa-yy") )
( INST_cy_SPKR_diphone_1442	"sil @ n xx d aa - ei d sil"	("aa-ei") )
( INST_cy_SPKR_diphone_1443	"sil @ n xx d aa - ai d sil"	("aa-ai") )
( INST_cy_SPKR_diphone_1444	"sil @ n xx d aa - oi d sil"	("aa-oi") )
( INST_cy_SPKR_diphone_1445	"sil @ n xx d aa - iu d sil"	("aa-iu") )
( INST_cy_SPKR_diphone_1446	"sil @ n xx d aa - eu d sil"	("aa-eu") )
( INST_cy_SPKR_diphone_1447	"sil @ n xx d aa - au d sil"	("aa-au") )
( INST_cy_SPKR_diphone_1448	"sil @ n xx d aa - ou d sil"	("aa-ou") )
( INST_cy_SPKR_diphone_1449	"sil @ n xx d aa - uy d sil"	("aa-uy") )
( INST_cy_SPKR_diphone_1450	"sil @ n xx d aa - yu d sil"	("aa-yu") )
( INST_cy_SPKR_diphone_1451	"sil @ n xx d aa - ay d sil"	("aa-ay") )
( INST_cy_SPKR_diphone_1452	"sil @ n xx d aa - aay d sil"	("aa-aay") )
( INST_cy_SPKR_diphone_1453	"sil @ n xx d aa - ey d sil"	("aa-ey") )
( INST_cy_SPKR_diphone_1454	"sil @ n xx d aa - oy d sil"	("aa-oy") )
( INST_cy_SPKR_diphone_1455	"sil @ n xx d oo - ii d sil"	("oo-ii") )
( INST_cy_SPKR_diphone_1456	"sil @ n xx d oo - ee d sil"	("oo-ee") )
( INST_cy_SPKR_diphone_1457	"sil @ n xx d oo - aa d sil"	("oo-aa") )
( INST_cy_SPKR_diphone_1458	"sil @ n xx d oo - oo d sil"	("oo-oo") )
( INST_cy_SPKR_diphone_1459	"sil @ n xx d oo - uu d sil"	("oo-uu") )
( INST_cy_SPKR_diphone_1460	"sil @ n xx d oo - yy d sil"	("oo-yy") )
( INST_cy_SPKR_diphone_1461	"sil @ n xx d oo - ei d sil"	("oo-ei") )
( INST_cy_SPKR_diphone_1462	"sil @ n xx d oo - ai d sil"	("oo-ai") )
( INST_cy_SPKR_diphone_1463	"sil @ n xx d oo - oi d sil"	("oo-oi") )
( INST_cy_SPKR_diphone_1464	"sil @ n xx d oo - iu d sil"	("oo-iu") )
( INST_cy_SPKR_diphone_1465	"sil @ n xx d oo - eu d sil"	("oo-eu") )
( INST_cy_SPKR_diphone_1466	"sil @ n xx d oo - au d sil"	("oo-au") )
( INST_cy_SPKR_diphone_1467	"sil @ n xx d oo - ou d sil"	("oo-ou") )
( INST_cy_SPKR_diphone_1468	"sil @ n xx d oo - uy d sil"	("oo-uy") )
( INST_cy_SPKR_diphone_1469	"sil @ n xx d oo - yu d sil"	("oo-yu") )
( INST_cy_SPKR_diphone_1470	"sil @ n xx d oo - ay d sil"	("oo-ay") )
( INST_cy_SPKR_diphone_1471	"sil @ n xx d oo - aay d sil"	("oo-aay") )
( INST_cy_SPKR_diphone_1472	"sil @ n xx d oo - ey d sil"	("oo-ey") )
( INST_cy_SPKR_diphone_1473	"sil @ n xx d oo - oy d sil"	("oo-oy") )
( INST_cy_SPKR_diphone_1474	"sil @ n xx d uu - ii d sil"	("uu-ii") )
( INST_cy_SPKR_diphone_1475	"sil @ n xx d uu - ee d sil"	("uu-ee") )
( INST_cy_SPKR_diphone_1476	"sil @ n xx d uu - aa d sil"	("uu-aa") )
( INST_cy_SPKR_diphone_1477	"sil @ n xx d uu - oo d sil"	("uu-oo") )
( INST_cy_SPKR_diphone_1478	"sil @ n xx d uu - uu d sil"	("uu-uu") )
( INST_cy_SPKR_diphone_1479	"sil @ n xx d uu - yy d sil"	("uu-yy") )
( INST_cy_SPKR_diphone_1480	"sil @ n xx d uu - ei d sil"	("uu-ei") )
( INST_cy_SPKR_diphone_1481	"sil @ n xx d uu - ai d sil"	("uu-ai") )
( INST_cy_SPKR_diphone_1482	"sil @ n xx d uu - oi d sil"	("uu-oi") )
( INST_cy_SPKR_diphone_1483	"sil @ n xx d uu - iu d sil"	("uu-iu") )
( INST_cy_SPKR_diphone_1484	"sil @ n xx d uu - eu d sil"	("uu-eu") )
( INST_cy_SPKR_diphone_1485	"sil @ n xx d uu - au d sil"	("uu-au") )
( INST_cy_SPKR_diphone_1486	"sil @ n xx d uu - ou d sil"	("uu-ou") )
( INST_cy_SPKR_diphone_1487	"sil @ n xx d uu - uy d sil"	("uu-uy") )
( INST_cy_SPKR_diphone_1488	"sil @ n xx d uu - yu d sil"	("uu-yu") )
( INST_cy_SPKR_diphone_1489	"sil @ n xx d uu - ay d sil"	("uu-ay") )
( INST_cy_SPKR_diphone_1490	"sil @ n xx d uu - aay d sil"	("uu-aay") )
( INST_cy_SPKR_diphone_1491	"sil @ n xx d uu - ey d sil"	("uu-ey") )
( INST_cy_SPKR_diphone_1492	"sil @ n xx d uu - oy d sil"	("uu-oy") )
( INST_cy_SPKR_diphone_1493	"sil @ n xx d yy - ii d sil"	("yy-ii") )
( INST_cy_SPKR_diphone_1494	"sil @ n xx d yy - ee d sil"	("yy-ee") )
( INST_cy_SPKR_diphone_1495	"sil @ n xx d yy - aa d sil"	("yy-aa") )
( INST_cy_SPKR_diphone_1496	"sil @ n xx d yy - oo d sil"	("yy-oo") )
( INST_cy_SPKR_diphone_1497	"sil @ n xx d yy - uu d sil"	("yy-uu") )
( INST_cy_SPKR_diphone_1498	"sil @ n xx d yy - yy d sil"	("yy-yy") )
( INST_cy_SPKR_diphone_1499	"sil @ n xx d yy - ei d sil"	("yy-ei") )
( INST_cy_SPKR_diphone_1500	"sil @ n xx d yy - ai d sil"	("yy-ai") )
( INST_cy_SPKR_diphone_1501	"sil @ n xx d yy - oi d sil"	("yy-oi") )
( INST_cy_SPKR_diphone_1502	"sil @ n xx d yy - iu d sil"	("yy-iu") )
( INST_cy_SPKR_diphone_1503	"sil @ n xx d yy - eu d sil"	("yy-eu") )
( INST_cy_SPKR_diphone_1504	"sil @ n xx d yy - au d sil"	("yy-au") )
( INST_cy_SPKR_diphone_1505	"sil @ n xx d yy - ou d sil"	("yy-ou") )
( INST_cy_SPKR_diphone_1506	"sil @ n xx d yy - uy d sil"	("yy-uy") )
( INST_cy_SPKR_diphone_1507	"sil @ n xx d yy - yu d sil"	("yy-yu") )
( INST_cy_SPKR_diphone_1508	"sil @ n xx d yy - ay d sil"	("yy-ay") )
( INST_cy_SPKR_diphone_1509	"sil @ n xx d yy - aay d sil"	("yy-aay") )
( INST_cy_SPKR_diphone_1510	"sil @ n xx d yy - ey d sil"	("yy-ey") )
( INST_cy_SPKR_diphone_1511	"sil @ n xx d yy - oy d sil"	("yy-oy") )
( INST_cy_SPKR_diphone_1512	"sil @ n xx d ei - ii d sil"	("ei-ii") )
( INST_cy_SPKR_diphone_1513	"sil @ n xx d ei - ee d sil"	("ei-ee") )
( INST_cy_SPKR_diphone_1514	"sil @ n xx d ei - aa d sil"	("ei-aa") )
( INST_cy_SPKR_diphone_1515	"sil @ n xx d ei - oo d sil"	("ei-oo") )
( INST_cy_SPKR_diphone_1516	"sil @ n xx d ei - uu d sil"	("ei-uu") )
( INST_cy_SPKR_diphone_1517	"sil @ n xx d ei - yy d sil"	("ei-yy") )
( INST_cy_SPKR_diphone_1518	"sil @ n xx d ei - ei d sil"	("ei-ei") )
( INST_cy_SPKR_diphone_1519	"sil @ n xx d ei - ai d sil"	("ei-ai") )
( INST_cy_SPKR_diphone_1520	"sil @ n xx d ei - oi d sil"	("ei-oi") )
( INST_cy_SPKR_diphone_1521	"sil @ n xx d ei - iu d sil"	("ei-iu") )
( INST_cy_SPKR_diphone_1522	"sil @ n xx d ei - eu d sil"	("ei-eu") )
( INST_cy_SPKR_diphone_1523	"sil @ n xx d ei - au d sil"	("ei-au") )
( INST_cy_SPKR_diphone_1524	"sil @ n xx d ei - ou d sil"	("ei-ou") )
( INST_cy_SPKR_diphone_1525	"sil @ n xx d ei - uy d sil"	("ei-uy") )
( INST_cy_SPKR_diphone_1526	"sil @ n xx d ei - yu d sil"	("ei-yu") )
( INST_cy_SPKR_diphone_1527	"sil @ n xx d ei - ay d sil"	("ei-ay") )
( INST_cy_SPKR_diphone_1528	"sil @ n xx d ei - aay d sil"	("ei-aay") )
( INST_cy_SPKR_diphone_1529	"sil @ n xx d ei - ey d sil"	("ei-ey") )
( INST_cy_SPKR_diphone_1530	"sil @ n xx d ei - oy d sil"	("ei-oy") )
( INST_cy_SPKR_diphone_1531	"sil @ n xx d ai - ii d sil"	("ai-ii") )
( INST_cy_SPKR_diphone_1532	"sil @ n xx d ai - ee d sil"	("ai-ee") )
( INST_cy_SPKR_diphone_1533	"sil @ n xx d ai - aa d sil"	("ai-aa") )
( INST_cy_SPKR_diphone_1534	"sil @ n xx d ai - oo d sil"	("ai-oo") )
( INST_cy_SPKR_diphone_1535	"sil @ n xx d ai - uu d sil"	("ai-uu") )
( INST_cy_SPKR_diphone_1536	"sil @ n xx d ai - yy d sil"	("ai-yy") )
( INST_cy_SPKR_diphone_1537	"sil @ n xx d ai - ei d sil"	("ai-ei") )
( INST_cy_SPKR_diphone_1538	"sil @ n xx d ai - ai d sil"	("ai-ai") )
( INST_cy_SPKR_diphone_1539	"sil @ n xx d ai - oi d sil"	("ai-oi") )
( INST_cy_SPKR_diphone_1540	"sil @ n xx d ai - iu d sil"	("ai-iu") )
( INST_cy_SPKR_diphone_1541	"sil @ n xx d ai - eu d sil"	("ai-eu") )
( INST_cy_SPKR_diphone_1542	"sil @ n xx d ai - au d sil"	("ai-au") )
( INST_cy_SPKR_diphone_1543	"sil @ n xx d ai - ou d sil"	("ai-ou") )
( INST_cy_SPKR_diphone_1544	"sil @ n xx d ai - uy d sil"	("ai-uy") )
( INST_cy_SPKR_diphone_1545	"sil @ n xx d ai - yu d sil"	("ai-yu") )
( INST_cy_SPKR_diphone_1546	"sil @ n xx d ai - ay d sil"	("ai-ay") )
( INST_cy_SPKR_diphone_1547	"sil @ n xx d ai - aay d sil"	("ai-aay") )
( INST_cy_SPKR_diphone_1548	"sil @ n xx d ai - ey d sil"	("ai-ey") )
( INST_cy_SPKR_diphone_1549	"sil @ n xx d ai - oy d sil"	("ai-oy") )
( INST_cy_SPKR_diphone_1550	"sil @ n xx d oi - ii d sil"	("oi-ii") )
( INST_cy_SPKR_diphone_1551	"sil @ n xx d oi - ee d sil"	("oi-ee") )
( INST_cy_SPKR_diphone_1552	"sil @ n xx d oi - aa d sil"	("oi-aa") )
( INST_cy_SPKR_diphone_1553	"sil @ n xx d oi - oo d sil"	("oi-oo") )
( INST_cy_SPKR_diphone_1554	"sil @ n xx d oi - uu d sil"	("oi-uu") )
( INST_cy_SPKR_diphone_1555	"sil @ n xx d oi - yy d sil"	("oi-yy") )
( INST_cy_SPKR_diphone_1556	"sil @ n xx d oi - ei d sil"	("oi-ei") )
( INST_cy_SPKR_diphone_1557	"sil @ n xx d oi - ai d sil"	("oi-ai") )
( INST_cy_SPKR_diphone_1558	"sil @ n xx d oi - oi d sil"	("oi-oi") )
( INST_cy_SPKR_diphone_1559	"sil @ n xx d oi - iu d sil"	("oi-iu") )
( INST_cy_SPKR_diphone_1560	"sil @ n xx d oi - eu d sil"	("oi-eu") )
( INST_cy_SPKR_diphone_1561	"sil @ n xx d oi - au d sil"	("oi-au") )
( INST_cy_SPKR_diphone_1562	"sil @ n xx d oi - ou d sil"	("oi-ou") )
( INST_cy_SPKR_diphone_1563	"sil @ n xx d oi - uy d sil"	("oi-uy") )
( INST_cy_SPKR_diphone_1564	"sil @ n xx d oi - yu d sil"	("oi-yu") )
( INST_cy_SPKR_diphone_1565	"sil @ n xx d oi - ay d sil"	("oi-ay") )
( INST_cy_SPKR_diphone_1566	"sil @ n xx d oi - aay d sil"	("oi-aay") )
( INST_cy_SPKR_diphone_1567	"sil @ n xx d oi - ey d sil"	("oi-ey") )
( INST_cy_SPKR_diphone_1568	"sil @ n xx d oi - oy d sil"	("oi-oy") )
( INST_cy_SPKR_diphone_1569	"sil @ n xx d iu - ii d sil"	("iu-ii") )
( INST_cy_SPKR_diphone_1570	"sil @ n xx d iu - ee d sil"	("iu-ee") )
( INST_cy_SPKR_diphone_1571	"sil @ n xx d iu - aa d sil"	("iu-aa") )
( INST_cy_SPKR_diphone_1572	"sil @ n xx d iu - oo d sil"	("iu-oo") )
( INST_cy_SPKR_diphone_1573	"sil @ n xx d iu - uu d sil"	("iu-uu") )
( INST_cy_SPKR_diphone_1574	"sil @ n xx d iu - yy d sil"	("iu-yy") )
( INST_cy_SPKR_diphone_1575	"sil @ n xx d iu - ei d sil"	("iu-ei") )
( INST_cy_SPKR_diphone_1576	"sil @ n xx d iu - ai d sil"	("iu-ai") )
( INST_cy_SPKR_diphone_1577	"sil @ n xx d iu - oi d sil"	("iu-oi") )
( INST_cy_SPKR_diphone_1578	"sil @ n xx d iu - iu d sil"	("iu-iu") )
( INST_cy_SPKR_diphone_1579	"sil @ n xx d iu - eu d sil"	("iu-eu") )
( INST_cy_SPKR_diphone_1580	"sil @ n xx d iu - au d sil"	("iu-au") )
( INST_cy_SPKR_diphone_1581	"sil @ n xx d iu - ou d sil"	("iu-ou") )
( INST_cy_SPKR_diphone_1582	"sil @ n xx d iu - uy d sil"	("iu-uy") )
( INST_cy_SPKR_diphone_1583	"sil @ n xx d iu - yu d sil"	("iu-yu") )
( INST_cy_SPKR_diphone_1584	"sil @ n xx d iu - ay d sil"	("iu-ay") )
( INST_cy_SPKR_diphone_1585	"sil @ n xx d iu - aay d sil"	("iu-aay") )
( INST_cy_SPKR_diphone_1586	"sil @ n xx d iu - ey d sil"	("iu-ey") )
( INST_cy_SPKR_diphone_1587	"sil @ n xx d iu - oy d sil"	("iu-oy") )
( INST_cy_SPKR_diphone_1588	"sil @ n xx d eu - ii d sil"	("eu-ii") )
( INST_cy_SPKR_diphone_1589	"sil @ n xx d eu - ee d sil"	("eu-ee") )
( INST_cy_SPKR_diphone_1590	"sil @ n xx d eu - aa d sil"	("eu-aa") )
( INST_cy_SPKR_diphone_1591	"sil @ n xx d eu - oo d sil"	("eu-oo") )
( INST_cy_SPKR_diphone_1592	"sil @ n xx d eu - uu d sil"	("eu-uu") )
( INST_cy_SPKR_diphone_1593	"sil @ n xx d eu - yy d sil"	("eu-yy") )
( INST_cy_SPKR_diphone_1594	"sil @ n xx d eu - ei d sil"	("eu-ei") )
( INST_cy_SPKR_diphone_1595	"sil @ n xx d eu - ai d sil"	("eu-ai") )
( INST_cy_SPKR_diphone_1596	"sil @ n xx d eu - oi d sil"	("eu-oi") )
( INST_cy_SPKR_diphone_1597	"sil @ n xx d eu - iu d sil"	("eu-iu") )
( INST_cy_SPKR_diphone_1598	"sil @ n xx d eu - eu d sil"	("eu-eu") )
( INST_cy_SPKR_diphone_1599	"sil @ n xx d eu - au d sil"	("eu-au") )
( INST_cy_SPKR_diphone_1600	"sil @ n xx d eu - ou d sil"	("eu-ou") )
( INST_cy_SPKR_diphone_1601	"sil @ n xx d eu - uy d sil"	("eu-uy") )
( INST_cy_SPKR_diphone_1602	"sil @ n xx d eu - yu d sil"	("eu-yu") )
( INST_cy_SPKR_diphone_1603	"sil @ n xx d eu - ay d sil"	("eu-ay") )
( INST_cy_SPKR_diphone_1604	"sil @ n xx d eu - aay d sil"	("eu-aay") )
( INST_cy_SPKR_diphone_1605	"sil @ n xx d eu - ey d sil"	("eu-ey") )
( INST_cy_SPKR_diphone_1606	"sil @ n xx d eu - oy d sil"	("eu-oy") )
( INST_cy_SPKR_diphone_1607	"sil @ n xx d au - ii d sil"	("au-ii") )
( INST_cy_SPKR_diphone_1608	"sil @ n xx d au - ee d sil"	("au-ee") )
( INST_cy_SPKR_diphone_1609	"sil @ n xx d au - aa d sil"	("au-aa") )
( INST_cy_SPKR_diphone_1610	"sil @ n xx d au - oo d sil"	("au-oo") )
( INST_cy_SPKR_diphone_1611	"sil @ n xx d au - uu d sil"	("au-uu") )
( INST_cy_SPKR_diphone_1612	"sil @ n xx d au - yy d sil"	("au-yy") )
( INST_cy_SPKR_diphone_1613	"sil @ n xx d au - ei d sil"	("au-ei") )
( INST_cy_SPKR_diphone_1614	"sil @ n xx d au - ai d sil"	("au-ai") )
( INST_cy_SPKR_diphone_1615	"sil @ n xx d au - oi d sil"	("au-oi") )
( INST_cy_SPKR_diphone_1616	"sil @ n xx d au - iu d sil"	("au-iu") )
( INST_cy_SPKR_diphone_1617	"sil @ n xx d au - eu d sil"	("au-eu") )
( INST_cy_SPKR_diphone_1618	"sil @ n xx d au - au d sil"	("au-au") )
( INST_cy_SPKR_diphone_1619	"sil @ n xx d au - ou d sil"	("au-ou") )
( INST_cy_SPKR_diphone_1620	"sil @ n xx d au - uy d sil"	("au-uy") )
( INST_cy_SPKR_diphone_1621	"sil @ n xx d au - yu d sil"	("au-yu") )
( INST_cy_SPKR_diphone_1622	"sil @ n xx d au - ay d sil"	("au-ay") )
( INST_cy_SPKR_diphone_1623	"sil @ n xx d au - aay d sil"	("au-aay") )
( INST_cy_SPKR_diphone_1624	"sil @ n xx d au - ey d sil"	("au-ey") )
( INST_cy_SPKR_diphone_1625	"sil @ n xx d au - oy d sil"	("au-oy") )
( INST_cy_SPKR_diphone_1626	"sil @ n xx d ou - ii d sil"	("ou-ii") )
( INST_cy_SPKR_diphone_1627	"sil @ n xx d ou - ee d sil"	("ou-ee") )
( INST_cy_SPKR_diphone_1628	"sil @ n xx d ou - aa d sil"	("ou-aa") )
( INST_cy_SPKR_diphone_1629	"sil @ n xx d ou - oo d sil"	("ou-oo") )
( INST_cy_SPKR_diphone_1630	"sil @ n xx d ou - uu d sil"	("ou-uu") )
( INST_cy_SPKR_diphone_1631	"sil @ n xx d ou - yy d sil"	("ou-yy") )
( INST_cy_SPKR_diphone_1632	"sil @ n xx d ou - ei d sil"	("ou-ei") )
( INST_cy_SPKR_diphone_1633	"sil @ n xx d ou - ai d sil"	("ou-ai") )
( INST_cy_SPKR_diphone_1634	"sil @ n xx d ou - oi d sil"	("ou-oi") )
( INST_cy_SPKR_diphone_1635	"sil @ n xx d ou - iu d sil"	("ou-iu") )
( INST_cy_SPKR_diphone_1636	"sil @ n xx d ou - eu d sil"	("ou-eu") )
( INST_cy_SPKR_diphone_1637	"sil @ n xx d ou - au d sil"	("ou-au") )
( INST_cy_SPKR_diphone_1638	"sil @ n xx d ou - ou d sil"	("ou-ou") )
( INST_cy_SPKR_diphone_1639	"sil @ n xx d ou - uy d sil"	("ou-uy") )
( INST_cy_SPKR_diphone_1640	"sil @ n xx d ou - yu d sil"	("ou-yu") )
( INST_cy_SPKR_diphone_1641	"sil @ n xx d ou - ay d sil"	("ou-ay") )
( INST_cy_SPKR_diphone_1642	"sil @ n xx d ou - aay d sil"	("ou-aay") )
( INST_cy_SPKR_diphone_1643	"sil @ n xx d ou - ey d sil"	("ou-ey") )
( INST_cy_SPKR_diphone_1644	"sil @ n xx d ou - oy d sil"	("ou-oy") )
( INST_cy_SPKR_diphone_1645	"sil @ n xx d uy - ii d sil"	("uy-ii") )
( INST_cy_SPKR_diphone_1646	"sil @ n xx d uy - ee d sil"	("uy-ee") )
( INST_cy_SPKR_diphone_1647	"sil @ n xx d uy - aa d sil"	("uy-aa") )
( INST_cy_SPKR_diphone_1648	"sil @ n xx d uy - oo d sil"	("uy-oo") )
( INST_cy_SPKR_diphone_1649	"sil @ n xx d uy - uu d sil"	("uy-uu") )
( INST_cy_SPKR_diphone_1650	"sil @ n xx d uy - yy d sil"	("uy-yy") )
( INST_cy_SPKR_diphone_1651	"sil @ n xx d uy - ei d sil"	("uy-ei") )
( INST_cy_SPKR_diphone_1652	"sil @ n xx d uy - ai d sil"	("uy-ai") )
( INST_cy_SPKR_diphone_1653	"sil @ n xx d uy - oi d sil"	("uy-oi") )
( INST_cy_SPKR_diphone_1654	"sil @ n xx d uy - iu d sil"	("uy-iu") )
( INST_cy_SPKR_diphone_1655	"sil @ n xx d uy - eu d sil"	("uy-eu") )
( INST_cy_SPKR_diphone_1656	"sil @ n xx d uy - au d sil"	("uy-au") )
( INST_cy_SPKR_diphone_1657	"sil @ n xx d uy - ou d sil"	("uy-ou") )
( INST_cy_SPKR_diphone_1658	"sil @ n xx d uy - uy d sil"	("uy-uy") )
( INST_cy_SPKR_diphone_1659	"sil @ n xx d uy - yu d sil"	("uy-yu") )
( INST_cy_SPKR_diphone_1660	"sil @ n xx d uy - ay d sil"	("uy-ay") )
( INST_cy_SPKR_diphone_1661	"sil @ n xx d uy - aay d sil"	("uy-aay") )
( INST_cy_SPKR_diphone_1662	"sil @ n xx d uy - ey d sil"	("uy-ey") )
( INST_cy_SPKR_diphone_1663	"sil @ n xx d uy - oy d sil"	("uy-oy") )
( INST_cy_SPKR_diphone_1664	"sil @ n xx d yu - ii d sil"	("yu-ii") )
( INST_cy_SPKR_diphone_1665	"sil @ n xx d yu - ee d sil"	("yu-ee") )
( INST_cy_SPKR_diphone_1666	"sil @ n xx d yu - aa d sil"	("yu-aa") )
( INST_cy_SPKR_diphone_1667	"sil @ n xx d yu - oo d sil"	("yu-oo") )
( INST_cy_SPKR_diphone_1668	"sil @ n xx d yu - uu d sil"	("yu-uu") )
( INST_cy_SPKR_diphone_1669	"sil @ n xx d yu - yy d sil"	("yu-yy") )
( INST_cy_SPKR_diphone_1670	"sil @ n xx d yu - ei d sil"	("yu-ei") )
( INST_cy_SPKR_diphone_1671	"sil @ n xx d yu - ai d sil"	("yu-ai") )
( INST_cy_SPKR_diphone_1672	"sil @ n xx d yu - oi d sil"	("yu-oi") )
( INST_cy_SPKR_diphone_1673	"sil @ n xx d yu - iu d sil"	("yu-iu") )
( INST_cy_SPKR_diphone_1674	"sil @ n xx d yu - eu d sil"	("yu-eu") )
( INST_cy_SPKR_diphone_1675	"sil @ n xx d yu - au d sil"	("yu-au") )
( INST_cy_SPKR_diphone_1676	"sil @ n xx d yu - ou d sil"	("yu-ou") )
( INST_cy_SPKR_diphone_1677	"sil @ n xx d yu - uy d sil"	("yu-uy") )
( INST_cy_SPKR_diphone_1678	"sil @ n xx d yu - yu d sil"	("yu-yu") )
( INST_cy_SPKR_diphone_1679	"sil @ n xx d yu - ay d sil"	("yu-ay") )
( INST_cy_SPKR_diphone_1680	"sil @ n xx d yu - aay d sil"	("yu-aay") )
( INST_cy_SPKR_diphone_1681	"sil @ n xx d yu - ey d sil"	("yu-ey") )
( INST_cy_SPKR_diphone_1682	"sil @ n xx d yu - oy d sil"	("yu-oy") )
( INST_cy_SPKR_diphone_1683	"sil @ n xx d ay - ii d sil"	("ay-ii") )
( INST_cy_SPKR_diphone_1684	"sil @ n xx d ay - ee d sil"	("ay-ee") )
( INST_cy_SPKR_diphone_1685	"sil @ n xx d ay - aa d sil"	("ay-aa") )
( INST_cy_SPKR_diphone_1686	"sil @ n xx d ay - oo d sil"	("ay-oo") )
( INST_cy_SPKR_diphone_1687	"sil @ n xx d ay - uu d sil"	("ay-uu") )
( INST_cy_SPKR_diphone_1688	"sil @ n xx d ay - yy d sil"	("ay-yy") )
( INST_cy_SPKR_diphone_1689	"sil @ n xx d ay - ei d sil"	("ay-ei") )
( INST_cy_SPKR_diphone_1690	"sil @ n xx d ay - ai d sil"	("ay-ai") )
( INST_cy_SPKR_diphone_1691	"sil @ n xx d ay - oi d sil"	("ay-oi") )
( INST_cy_SPKR_diphone_1692	"sil @ n xx d ay - iu d sil"	("ay-iu") )
( INST_cy_SPKR_diphone_1693	"sil @ n xx d ay - eu d sil"	("ay-eu") )
( INST_cy_SPKR_diphone_1694	"sil @ n xx d ay - au d sil"	("ay-au") )
( INST_cy_SPKR_diphone_1695	"sil @ n xx d ay - ou d sil"	("ay-ou") )
( INST_cy_SPKR_diphone_1696	"sil @ n xx d ay - uy d sil"	("ay-uy") )
( INST_cy_SPKR_diphone_1697	"sil @ n xx d ay - yu d sil"	("ay-yu") )
( INST_cy_SPKR_diphone_1698	"sil @ n xx d ay - ay d sil"	("ay-ay") )
( INST_cy_SPKR_diphone_1699	"sil @ n xx d ay - aay d sil"	("ay-aay") )
( INST_cy_SPKR_diphone_1700	"sil @ n xx d ay - ey d sil"	("ay-ey") )
( INST_cy_SPKR_diphone_1701	"sil @ n xx d ay - oy d sil"	("ay-oy") )
( INST_cy_SPKR_diphone_1702	"sil @ n xx d aay - ii d sil"	("aay-ii") )
( INST_cy_SPKR_diphone_1703	"sil @ n xx d aay - ee d sil"	("aay-ee") )
( INST_cy_SPKR_diphone_1704	"sil @ n xx d aay - aa d sil"	("aay-aa") )
( INST_cy_SPKR_diphone_1705	"sil @ n xx d aay - oo d sil"	("aay-oo") )
( INST_cy_SPKR_diphone_1706	"sil @ n xx d aay - uu d sil"	("aay-uu") )
( INST_cy_SPKR_diphone_1707	"sil @ n xx d aay - yy d sil"	("aay-yy") )
( INST_cy_SPKR_diphone_1708	"sil @ n xx d aay - ei d sil"	("aay-ei") )
( INST_cy_SPKR_diphone_1709	"sil @ n xx d aay - ai d sil"	("aay-ai") )
( INST_cy_SPKR_diphone_1710	"sil @ n xx d aay - oi d sil"	("aay-oi") )
( INST_cy_SPKR_diphone_1711	"sil @ n xx d aay - iu d sil"	("aay-iu") )
( INST_cy_SPKR_diphone_1712	"sil @ n xx d aay - eu d sil"	("aay-eu") )
( INST_cy_SPKR_diphone_1713	"sil @ n xx d aay - au d sil"	("aay-au") )
( INST_cy_SPKR_diphone_1714	"sil @ n xx d aay - ou d sil"	("aay-ou") )
( INST_cy_SPKR_diphone_1715	"sil @ n xx d aay - uy d sil"	("aay-uy") )
( INST_cy_SPKR_diphone_1716	"sil @ n xx d aay - yu d sil"	("aay-yu") )
( INST_cy_SPKR_diphone_1717	"sil @ n xx d aay - ay d sil"	("aay-ay") )
( INST_cy_SPKR_diphone_1718	"sil @ n xx d aay - aay d sil"	("aay-aay") )
( INST_cy_SPKR_diphone_1719	"sil @ n xx d aay - ey d sil"	("aay-ey") )
( INST_cy_SPKR_diphone_1720	"sil @ n xx d aay - oy d sil"	("aay-oy") )
( INST_cy_SPKR_diphone_1721	"sil @ n xx d ey - ii d sil"	("ey-ii") )
( INST_cy_SPKR_diphone_1722	"sil @ n xx d ey - ee d sil"	("ey-ee") )
( INST_cy_SPKR_diphone_1723	"sil @ n xx d ey - aa d sil"	("ey-aa") )
( INST_cy_SPKR_diphone_1724	"sil @ n xx d ey - oo d sil"	("ey-oo") )
( INST_cy_SPKR_diphone_1725	"sil @ n xx d ey - uu d sil"	("ey-uu") )
( INST_cy_SPKR_diphone_1726	"sil @ n xx d ey - yy d sil"	("ey-yy") )
( INST_cy_SPKR_diphone_1727	"sil @ n xx d ey - ei d sil"	("ey-ei") )
( INST_cy_SPKR_diphone_1728	"sil @ n xx d ey - ai d sil"	("ey-ai") )
( INST_cy_SPKR_diphone_1729	"sil @ n xx d ey - oi d sil"	("ey-oi") )
( INST_cy_SPKR_diphone_1730	"sil @ n xx d ey - iu d sil"	("ey-iu") )
( INST_cy_SPKR_diphone_1731	"sil @ n xx d ey - eu d sil"	("ey-eu") )
( INST_cy_SPKR_diphone_1732	"sil @ n xx d ey - au d sil"	("ey-au") )
( INST_cy_SPKR_diphone_1733	"sil @ n xx d ey - ou d sil"	("ey-ou") )
( INST_cy_SPKR_diphone_1734	"sil @ n xx d ey - uy d sil"	("ey-uy") )
( INST_cy_SPKR_diphone_1735	"sil @ n xx d ey - yu d sil"	("ey-yu") )
( INST_cy_SPKR_diphone_1736	"sil @ n xx d ey - ay d sil"	("ey-ay") )
( INST_cy_SPKR_diphone_1737	"sil @ n xx d ey - aay d sil"	("ey-aay") )
( INST_cy_SPKR_diphone_1738	"sil @ n xx d ey - ey d sil"	("ey-ey") )
( INST_cy_SPKR_diphone_1739	"sil @ n xx d ey - oy d sil"	("ey-oy") )
( INST_cy_SPKR_diphone_1740	"sil @ n xx d oy - ii d sil"	("oy-ii") )
( INST_cy_SPKR_diphone_1741	"sil @ n xx d oy - ee d sil"	("oy-ee") )
( INST_cy_SPKR_diphone_1742	"sil @ n xx d oy - aa d sil"	("oy-aa") )
( INST_cy_SPKR_diphone_1743	"sil @ n xx d oy - oo d sil"	("oy-oo") )
( INST_cy_SPKR_diphone_1744	"sil @ n xx d oy - uu d sil"	("oy-uu") )
( INST_cy_SPKR_diphone_1745	"sil @ n xx d oy - yy d sil"	("oy-yy") )
( INST_cy_SPKR_diphone_1746	"sil @ n xx d oy - ei d sil"	("oy-ei") )
( INST_cy_SPKR_diphone_1747	"sil @ n xx d oy - ai d sil"	("oy-ai") )
( INST_cy_SPKR_diphone_1748	"sil @ n xx d oy - oi d sil"	("oy-oi") )
( INST_cy_SPKR_diphone_1749	"sil @ n xx d oy - iu d sil"	("oy-iu") )
( INST_cy_SPKR_diphone_1750	"sil @ n xx d oy - eu d sil"	("oy-eu") )
( INST_cy_SPKR_diphone_1751	"sil @ n xx d oy - au d sil"	("oy-au") )
( INST_cy_SPKR_diphone_1752	"sil @ n xx d oy - ou d sil"	("oy-ou") )
( INST_cy_SPKR_diphone_1753	"sil @ n xx d oy - uy d sil"	("oy-uy") )
( INST_cy_SPKR_diphone_1754	"sil @ n xx d oy - yu d sil"	("oy-yu") )
( INST_cy_SPKR_diphone_1755	"sil @ n xx d oy - ay d sil"	("oy-ay") )
( INST_cy_SPKR_diphone_1756	"sil @ n xx d oy - aay d sil"	("oy-aay") )
( INST_cy_SPKR_diphone_1757	"sil @ n xx d oy - ey d sil"	("oy-ey") )
( INST_cy_SPKR_diphone_1758	"sil @ n xx d oy - oy d sil"	("oy-oy") )
( INST_cy_SPKR_diphone_1759	"sil @ xx d a p - p a d sil"	("p-p") )
( INST_cy_SPKR_diphone_1760	"sil @ xx d a p - t a d sil"	("p-t") )
( INST_cy_SPKR_diphone_1761	"sil @ xx d a p - k a d sil"	("p-k") )
( INST_cy_SPKR_diphone_1762	"sil @ xx d a p - b a d sil"	("p-b") )
( INST_cy_SPKR_diphone_1763	"sil @ xx d a p - d a d sil"	("p-d") )
( INST_cy_SPKR_diphone_1764	"sil @ xx d a p - g a d sil"	("p-g") )
( INST_cy_SPKR_diphone_1765	"sil @ xx d a p - f a d sil"	("p-f") )
( INST_cy_SPKR_diphone_1766	"sil @ xx d a p - v a d sil"	("p-v") )
( INST_cy_SPKR_diphone_1767	"sil @ xx d a p - th a d sil"	("p-th") )
( INST_cy_SPKR_diphone_1768	"sil @ xx d a p - dh a d sil"	("p-dh") )
( INST_cy_SPKR_diphone_1769	"sil @ xx d a p - s a d sil"	("p-s") )
( INST_cy_SPKR_diphone_1770	"sil @ xx d a p - sh a d sil"	("p-sh") )
( INST_cy_SPKR_diphone_1771	"sil @ xx d a p - r a d sil"	("p-r") )
( INST_cy_SPKR_diphone_1772	"sil @ xx d a p - l a d sil"	("p-l") )
( INST_cy_SPKR_diphone_1773	"sil @ xx d a p - m a d sil"	("p-m") )
( INST_cy_SPKR_diphone_1774	"sil @ xx d a p - n a d sil"	("p-n") )
( INST_cy_SPKR_diphone_1775	"sil @ xx d a p - ng a d sil"	("p-ng") )
( INST_cy_SPKR_diphone_1776	"sil @ xx d a p - ch a d sil"	("p-ch") )
( INST_cy_SPKR_diphone_1777	"sil @ xx d a p - jh a d sil"	("p-jh") )
( INST_cy_SPKR_diphone_1778	"sil @ xx d a p - lh a d sil"	("p-lh") )
( INST_cy_SPKR_diphone_1779	"sil @ xx d a p - x a d sil"	("p-x") )
( INST_cy_SPKR_diphone_1780	"sil @ xx d a p - w a d sil"	("p-w") )
( INST_cy_SPKR_diphone_1781	"sil @ xx d a p - j a d sil"	("p-j") )
( INST_cy_SPKR_diphone_1782	"sil @ xx d a p - mh a d sil"	("p-mh") )
( INST_cy_SPKR_diphone_1783	"sil @ xx d a p - nh a d sil"	("p-nh") )
( INST_cy_SPKR_diphone_1784	"sil @ xx d a p - ngh a d sil"	("p-ngh") )
( INST_cy_SPKR_diphone_1785	"sil @ xx d a p - lw a d sil"	("p-lw") )
( INST_cy_SPKR_diphone_1786	"sil @ xx d a p - nw a d sil"	("p-nw") )
( INST_cy_SPKR_diphone_1787	"sil @ xx d a p - rw a d sil"	("p-rw") )
( INST_cy_SPKR_diphone_1788	"sil @ xx d a p - rh a d sil"	("p-rh") )
( INST_cy_SPKR_diphone_1789	"sil @ xx d a p - hh a d sil"	("p-hh") )
( INST_cy_SPKR_diphone_1790	"sil @ xx d a p - z a d sil"	("p-z") )
( INST_cy_SPKR_diphone_1791	"sil @ xx d a t - p a d sil"	("t-p") )
( INST_cy_SPKR_diphone_1792	"sil @ xx d a t - t a d sil"	("t-t") )
( INST_cy_SPKR_diphone_1793	"sil @ xx d a t - k a d sil"	("t-k") )
( INST_cy_SPKR_diphone_1794	"sil @ xx d a t - b a d sil"	("t-b") )
( INST_cy_SPKR_diphone_1795	"sil @ xx d a t - d a d sil"	("t-d") )
( INST_cy_SPKR_diphone_1796	"sil @ xx d a t - g a d sil"	("t-g") )
( INST_cy_SPKR_diphone_1797	"sil @ xx d a t - f a d sil"	("t-f") )
( INST_cy_SPKR_diphone_1798	"sil @ xx d a t - v a d sil"	("t-v") )
( INST_cy_SPKR_diphone_1799	"sil @ xx d a t - th a d sil"	("t-th") )
( INST_cy_SPKR_diphone_1800	"sil @ xx d a t - dh a d sil"	("t-dh") )
( INST_cy_SPKR_diphone_1801	"sil @ xx d a t - s a d sil"	("t-s") )
( INST_cy_SPKR_diphone_1802	"sil @ xx d a t - sh a d sil"	("t-sh") )
( INST_cy_SPKR_diphone_1803	"sil @ xx d a t - r a d sil"	("t-r") )
( INST_cy_SPKR_diphone_1804	"sil @ xx d a t - l a d sil"	("t-l") )
( INST_cy_SPKR_diphone_1805	"sil @ xx d a t - m a d sil"	("t-m") )
( INST_cy_SPKR_diphone_1806	"sil @ xx d a t - n a d sil"	("t-n") )
( INST_cy_SPKR_diphone_1807	"sil @ xx d a t - ng a d sil"	("t-ng") )
( INST_cy_SPKR_diphone_1808	"sil @ xx d a t - ch a d sil"	("t-ch") )
( INST_cy_SPKR_diphone_1809	"sil @ xx d a t - jh a d sil"	("t-jh") )
( INST_cy_SPKR_diphone_1810	"sil @ xx d a t - lh a d sil"	("t-lh") )
( INST_cy_SPKR_diphone_1811	"sil @ xx d a t - x a d sil"	("t-x") )
( INST_cy_SPKR_diphone_1812	"sil @ xx d a t - w a d sil"	("t-w") )
( INST_cy_SPKR_diphone_1813	"sil @ xx d a t - j a d sil"	("t-j") )
( INST_cy_SPKR_diphone_1814	"sil @ xx d a t - mh a d sil"	("t-mh") )
( INST_cy_SPKR_diphone_1815	"sil @ xx d a t - nh a d sil"	("t-nh") )
( INST_cy_SPKR_diphone_1816	"sil @ xx d a t - ngh a d sil"	("t-ngh") )
( INST_cy_SPKR_diphone_1817	"sil @ xx d a t - lw a d sil"	("t-lw") )
( INST_cy_SPKR_diphone_1818	"sil @ xx d a t - nw a d sil"	("t-nw") )
( INST_cy_SPKR_diphone_1819	"sil @ xx d a t - rw a d sil"	("t-rw") )
( INST_cy_SPKR_diphone_1820	"sil @ xx d a t - rh a d sil"	("t-rh") )
( INST_cy_SPKR_diphone_1821	"sil @ xx d a t - hh a d sil"	("t-hh") )
( INST_cy_SPKR_diphone_1822	"sil @ xx d a t - z a d sil"	("t-z") )
( INST_cy_SPKR_diphone_1823	"sil @ xx d a k - p a d sil"	("k-p") )
( INST_cy_SPKR_diphone_1824	"sil @ xx d a k - t a d sil"	("k-t") )
( INST_cy_SPKR_diphone_1825	"sil @ xx d a k - k a d sil"	("k-k") )
( INST_cy_SPKR_diphone_1826	"sil @ xx d a k - b a d sil"	("k-b") )
( INST_cy_SPKR_diphone_1827	"sil @ xx d a k - d a d sil"	("k-d") )
( INST_cy_SPKR_diphone_1828	"sil @ xx d a k - g a d sil"	("k-g") )
( INST_cy_SPKR_diphone_1829	"sil @ xx d a k - f a d sil"	("k-f") )
( INST_cy_SPKR_diphone_1830	"sil @ xx d a k - v a d sil"	("k-v") )
( INST_cy_SPKR_diphone_1831	"sil @ xx d a k - th a d sil"	("k-th") )
( INST_cy_SPKR_diphone_1832	"sil @ xx d a k - dh a d sil"	("k-dh") )
( INST_cy_SPKR_diphone_1833	"sil @ xx d a k - s a d sil"	("k-s") )
( INST_cy_SPKR_diphone_1834	"sil @ xx d a k - sh a d sil"	("k-sh") )
( INST_cy_SPKR_diphone_1835	"sil @ xx d a k - r a d sil"	("k-r") )
( INST_cy_SPKR_diphone_1836	"sil @ xx d a k - l a d sil"	("k-l") )
( INST_cy_SPKR_diphone_1837	"sil @ xx d a k - m a d sil"	("k-m") )
( INST_cy_SPKR_diphone_1838	"sil @ xx d a k - n a d sil"	("k-n") )
( INST_cy_SPKR_diphone_1839	"sil @ xx d a k - ng a d sil"	("k-ng") )
( INST_cy_SPKR_diphone_1840	"sil @ xx d a k - ch a d sil"	("k-ch") )
( INST_cy_SPKR_diphone_1841	"sil @ xx d a k - jh a d sil"	("k-jh") )
( INST_cy_SPKR_diphone_1842	"sil @ xx d a k - lh a d sil"	("k-lh") )
( INST_cy_SPKR_diphone_1843	"sil @ xx d a k - x a d sil"	("k-x") )
( INST_cy_SPKR_diphone_1844	"sil @ xx d a k - w a d sil"	("k-w") )
( INST_cy_SPKR_diphone_1845	"sil @ xx d a k - j a d sil"	("k-j") )
( INST_cy_SPKR_diphone_1846	"sil @ xx d a k - mh a d sil"	("k-mh") )
( INST_cy_SPKR_diphone_1847	"sil @ xx d a k - nh a d sil"	("k-nh") )
( INST_cy_SPKR_diphone_1848	"sil @ xx d a k - ngh a d sil"	("k-ngh") )
( INST_cy_SPKR_diphone_1849	"sil @ xx d a k - lw a d sil"	("k-lw") )
( INST_cy_SPKR_diphone_1850	"sil @ xx d a k - nw a d sil"	("k-nw") )
( INST_cy_SPKR_diphone_1851	"sil @ xx d a k - rw a d sil"	("k-rw") )
( INST_cy_SPKR_diphone_1852	"sil @ xx d a k - rh a d sil"	("k-rh") )
( INST_cy_SPKR_diphone_1853	"sil @ xx d a k - hh a d sil"	("k-hh") )
( INST_cy_SPKR_diphone_1854	"sil @ xx d a k - z a d sil"	("k-z") )
( INST_cy_SPKR_diphone_1855	"sil @ xx d a b - p a d sil"	("b-p") )
( INST_cy_SPKR_diphone_1856	"sil @ xx d a b - t a d sil"	("b-t") )
( INST_cy_SPKR_diphone_1857	"sil @ xx d a b - k a d sil"	("b-k") )
( INST_cy_SPKR_diphone_1858	"sil @ xx d a b - b a d sil"	("b-b") )
( INST_cy_SPKR_diphone_1859	"sil @ xx d a b - d a d sil"	("b-d") )
( INST_cy_SPKR_diphone_1860	"sil @ xx d a b - g a d sil"	("b-g") )
( INST_cy_SPKR_diphone_1861	"sil @ xx d a b - f a d sil"	("b-f") )
( INST_cy_SPKR_diphone_1862	"sil @ xx d a b - v a d sil"	("b-v") )
( INST_cy_SPKR_diphone_1863	"sil @ xx d a b - th a d sil"	("b-th") )
( INST_cy_SPKR_diphone_1864	"sil @ xx d a b - dh a d sil"	("b-dh") )
( INST_cy_SPKR_diphone_1865	"sil @ xx d a b - s a d sil"	("b-s") )
( INST_cy_SPKR_diphone_1866	"sil @ xx d a b - sh a d sil"	("b-sh") )
( INST_cy_SPKR_diphone_1867	"sil @ xx d a b - r a d sil"	("b-r") )
( INST_cy_SPKR_diphone_1868	"sil @ xx d a b - l a d sil"	("b-l") )
( INST_cy_SPKR_diphone_1869	"sil @ xx d a b - m a d sil"	("b-m") )
( INST_cy_SPKR_diphone_1870	"sil @ xx d a b - n a d sil"	("b-n") )
( INST_cy_SPKR_diphone_1871	"sil @ xx d a b - ng a d sil"	("b-ng") )
( INST_cy_SPKR_diphone_1872	"sil @ xx d a b - ch a d sil"	("b-ch") )
( INST_cy_SPKR_diphone_1873	"sil @ xx d a b - jh a d sil"	("b-jh") )
( INST_cy_SPKR_diphone_1874	"sil @ xx d a b - lh a d sil"	("b-lh") )
( INST_cy_SPKR_diphone_1875	"sil @ xx d a b - x a d sil"	("b-x") )
( INST_cy_SPKR_diphone_1876	"sil @ xx d a b - w a d sil"	("b-w") )
( INST_cy_SPKR_diphone_1877	"sil @ xx d a b - j a d sil"	("b-j") )
( INST_cy_SPKR_diphone_1878	"sil @ xx d a b - mh a d sil"	("b-mh") )
( INST_cy_SPKR_diphone_1879	"sil @ xx d a b - nh a d sil"	("b-nh") )
( INST_cy_SPKR_diphone_1880	"sil @ xx d a b - ngh a d sil"	("b-ngh") )
( INST_cy_SPKR_diphone_1881	"sil @ xx d a b - lw a d sil"	("b-lw") )
( INST_cy_SPKR_diphone_1882	"sil @ xx d a b - nw a d sil"	("b-nw") )
( INST_cy_SPKR_diphone_1883	"sil @ xx d a b - rw a d sil"	("b-rw") )
( INST_cy_SPKR_diphone_1884	"sil @ xx d a b - rh a d sil"	("b-rh") )
( INST_cy_SPKR_diphone_1885	"sil @ xx d a b - hh a d sil"	("b-hh") )
( INST_cy_SPKR_diphone_1886	"sil @ xx d a b - z a d sil"	("b-z") )
( INST_cy_SPKR_diphone_1887	"sil @ xx d a d - p a d sil"	("d-p") )
( INST_cy_SPKR_diphone_1888	"sil @ xx d a d - t a d sil"	("d-t") )
( INST_cy_SPKR_diphone_1889	"sil @ xx d a d - k a d sil"	("d-k") )
( INST_cy_SPKR_diphone_1890	"sil @ xx d a d - b a d sil"	("d-b") )
( INST_cy_SPKR_diphone_1891	"sil @ xx d a d - d a d sil"	("d-d") )
( INST_cy_SPKR_diphone_1892	"sil @ xx d a d - g a d sil"	("d-g") )
( INST_cy_SPKR_diphone_1893	"sil @ xx d a d - f a d sil"	("d-f") )
( INST_cy_SPKR_diphone_1894	"sil @ xx d a d - v a d sil"	("d-v") )
( INST_cy_SPKR_diphone_1895	"sil @ xx d a d - th a d sil"	("d-th") )
( INST_cy_SPKR_diphone_1896	"sil @ xx d a d - dh a d sil"	("d-dh") )
( INST_cy_SPKR_diphone_1897	"sil @ xx d a d - s a d sil"	("d-s") )
( INST_cy_SPKR_diphone_1898	"sil @ xx d a d - sh a d sil"	("d-sh") )
( INST_cy_SPKR_diphone_1899	"sil @ xx d a d - r a d sil"	("d-r") )
( INST_cy_SPKR_diphone_1900	"sil @ xx d a d - l a d sil"	("d-l") )
( INST_cy_SPKR_diphone_1901	"sil @ xx d a d - m a d sil"	("d-m") )
( INST_cy_SPKR_diphone_1902	"sil @ xx d a d - n a d sil"	("d-n") )
( INST_cy_SPKR_diphone_1903	"sil @ xx d a d - ng a d sil"	("d-ng") )
( INST_cy_SPKR_diphone_1904	"sil @ xx d a d - ch a d sil"	("d-ch") )
( INST_cy_SPKR_diphone_1905	"sil @ xx d a d - jh a d sil"	("d-jh") )
( INST_cy_SPKR_diphone_1906	"sil @ xx d a d - lh a d sil"	("d-lh") )
( INST_cy_SPKR_diphone_1907	"sil @ xx d a d - x a d sil"	("d-x") )
( INST_cy_SPKR_diphone_1908	"sil @ xx d a d - w a d sil"	("d-w") )
( INST_cy_SPKR_diphone_1909	"sil @ xx d a d - j a d sil"	("d-j") )
( INST_cy_SPKR_diphone_1910	"sil @ xx d a d - mh a d sil"	("d-mh") )
( INST_cy_SPKR_diphone_1911	"sil @ xx d a d - nh a d sil"	("d-nh") )
( INST_cy_SPKR_diphone_1912	"sil @ xx d a d - ngh a d sil"	("d-ngh") )
( INST_cy_SPKR_diphone_1913	"sil @ xx d a d - lw a d sil"	("d-lw") )
( INST_cy_SPKR_diphone_1914	"sil @ xx d a d - nw a d sil"	("d-nw") )
( INST_cy_SPKR_diphone_1915	"sil @ xx d a d - rw a d sil"	("d-rw") )
( INST_cy_SPKR_diphone_1916	"sil @ xx d a d - rh a d sil"	("d-rh") )
( INST_cy_SPKR_diphone_1917	"sil @ xx d a d - hh a d sil"	("d-hh") )
( INST_cy_SPKR_diphone_1918	"sil @ xx d a d - z a d sil"	("d-z") )
( INST_cy_SPKR_diphone_1919	"sil @ xx d a g - p a d sil"	("g-p") )
( INST_cy_SPKR_diphone_1920	"sil @ xx d a g - t a d sil"	("g-t") )
( INST_cy_SPKR_diphone_1921	"sil @ xx d a g - k a d sil"	("g-k") )
( INST_cy_SPKR_diphone_1922	"sil @ xx d a g - b a d sil"	("g-b") )
( INST_cy_SPKR_diphone_1923	"sil @ xx d a g - d a d sil"	("g-d") )
( INST_cy_SPKR_diphone_1924	"sil @ xx d a g - g a d sil"	("g-g") )
( INST_cy_SPKR_diphone_1925	"sil @ xx d a g - f a d sil"	("g-f") )
( INST_cy_SPKR_diphone_1926	"sil @ xx d a g - v a d sil"	("g-v") )
( INST_cy_SPKR_diphone_1927	"sil @ xx d a g - th a d sil"	("g-th") )
( INST_cy_SPKR_diphone_1928	"sil @ xx d a g - dh a d sil"	("g-dh") )
( INST_cy_SPKR_diphone_1929	"sil @ xx d a g - s a d sil"	("g-s") )
( INST_cy_SPKR_diphone_1930	"sil @ xx d a g - sh a d sil"	("g-sh") )
( INST_cy_SPKR_diphone_1931	"sil @ xx d a g - r a d sil"	("g-r") )
( INST_cy_SPKR_diphone_1932	"sil @ xx d a g - l a d sil"	("g-l") )
( INST_cy_SPKR_diphone_1933	"sil @ xx d a g - m a d sil"	("g-m") )
( INST_cy_SPKR_diphone_1934	"sil @ xx d a g - n a d sil"	("g-n") )
( INST_cy_SPKR_diphone_1935	"sil @ xx d a g - ng a d sil"	("g-ng") )
( INST_cy_SPKR_diphone_1936	"sil @ xx d a g - ch a d sil"	("g-ch") )
( INST_cy_SPKR_diphone_1937	"sil @ xx d a g - jh a d sil"	("g-jh") )
( INST_cy_SPKR_diphone_1938	"sil @ xx d a g - lh a d sil"	("g-lh") )
( INST_cy_SPKR_diphone_1939	"sil @ xx d a g - x a d sil"	("g-x") )
( INST_cy_SPKR_diphone_1940	"sil @ xx d a g - w a d sil"	("g-w") )
( INST_cy_SPKR_diphone_1941	"sil @ xx d a g - j a d sil"	("g-j") )
( INST_cy_SPKR_diphone_1942	"sil @ xx d a g - mh a d sil"	("g-mh") )
( INST_cy_SPKR_diphone_1943	"sil @ xx d a g - nh a d sil"	("g-nh") )
( INST_cy_SPKR_diphone_1944	"sil @ xx d a g - ngh a d sil"	("g-ngh") )
( INST_cy_SPKR_diphone_1945	"sil @ xx d a g - lw a d sil"	("g-lw") )
( INST_cy_SPKR_diphone_1946	"sil @ xx d a g - nw a d sil"	("g-nw") )
( INST_cy_SPKR_diphone_1947	"sil @ xx d a g - rw a d sil"	("g-rw") )
( INST_cy_SPKR_diphone_1948	"sil @ xx d a g - rh a d sil"	("g-rh") )
( INST_cy_SPKR_diphone_1949	"sil @ xx d a g - hh a d sil"	("g-hh") )
( INST_cy_SPKR_diphone_1950	"sil @ xx d a g - z a d sil"	("g-z") )
( INST_cy_SPKR_diphone_1951	"sil @ xx d a f - p a d sil"	("f-p") )
( INST_cy_SPKR_diphone_1952	"sil @ xx d a f - t a d sil"	("f-t") )
( INST_cy_SPKR_diphone_1953	"sil @ xx d a f - k a d sil"	("f-k") )
( INST_cy_SPKR_diphone_1954	"sil @ xx d a f - b a d sil"	("f-b") )
( INST_cy_SPKR_diphone_1955	"sil @ xx d a f - d a d sil"	("f-d") )
( INST_cy_SPKR_diphone_1956	"sil @ xx d a f - g a d sil"	("f-g") )
( INST_cy_SPKR_diphone_1957	"sil @ xx d a f - f a d sil"	("f-f") )
( INST_cy_SPKR_diphone_1958	"sil @ xx d a f - v a d sil"	("f-v") )
( INST_cy_SPKR_diphone_1959	"sil @ xx d a f - th a d sil"	("f-th") )
( INST_cy_SPKR_diphone_1960	"sil @ xx d a f - dh a d sil"	("f-dh") )
( INST_cy_SPKR_diphone_1961	"sil @ xx d a f - s a d sil"	("f-s") )
( INST_cy_SPKR_diphone_1962	"sil @ xx d a f - sh a d sil"	("f-sh") )
( INST_cy_SPKR_diphone_1963	"sil @ xx d a f - r a d sil"	("f-r") )
( INST_cy_SPKR_diphone_1964	"sil @ xx d a f - l a d sil"	("f-l") )
( INST_cy_SPKR_diphone_1965	"sil @ xx d a f - m a d sil"	("f-m") )
( INST_cy_SPKR_diphone_1966	"sil @ xx d a f - n a d sil"	("f-n") )
( INST_cy_SPKR_diphone_1967	"sil @ xx d a f - ng a d sil"	("f-ng") )
( INST_cy_SPKR_diphone_1968	"sil @ xx d a f - ch a d sil"	("f-ch") )
( INST_cy_SPKR_diphone_1969	"sil @ xx d a f - jh a d sil"	("f-jh") )
( INST_cy_SPKR_diphone_1970	"sil @ xx d a f - lh a d sil"	("f-lh") )
( INST_cy_SPKR_diphone_1971	"sil @ xx d a f - x a d sil"	("f-x") )
( INST_cy_SPKR_diphone_1972	"sil @ xx d a f - w a d sil"	("f-w") )
( INST_cy_SPKR_diphone_1973	"sil @ xx d a f - j a d sil"	("f-j") )
( INST_cy_SPKR_diphone_1974	"sil @ xx d a f - mh a d sil"	("f-mh") )
( INST_cy_SPKR_diphone_1975	"sil @ xx d a f - nh a d sil"	("f-nh") )
( INST_cy_SPKR_diphone_1976	"sil @ xx d a f - ngh a d sil"	("f-ngh") )
( INST_cy_SPKR_diphone_1977	"sil @ xx d a f - lw a d sil"	("f-lw") )
( INST_cy_SPKR_diphone_1978	"sil @ xx d a f - nw a d sil"	("f-nw") )
( INST_cy_SPKR_diphone_1979	"sil @ xx d a f - rw a d sil"	("f-rw") )
( INST_cy_SPKR_diphone_1980	"sil @ xx d a f - rh a d sil"	("f-rh") )
( INST_cy_SPKR_diphone_1981	"sil @ xx d a f - hh a d sil"	("f-hh") )
( INST_cy_SPKR_diphone_1982	"sil @ xx d a f - z a d sil"	("f-z") )
( INST_cy_SPKR_diphone_1983	"sil @ xx d a v - p a d sil"	("v-p") )
( INST_cy_SPKR_diphone_1984	"sil @ xx d a v - t a d sil"	("v-t") )
( INST_cy_SPKR_diphone_1985	"sil @ xx d a v - k a d sil"	("v-k") )
( INST_cy_SPKR_diphone_1986	"sil @ xx d a v - b a d sil"	("v-b") )
( INST_cy_SPKR_diphone_1987	"sil @ xx d a v - d a d sil"	("v-d") )
( INST_cy_SPKR_diphone_1988	"sil @ xx d a v - g a d sil"	("v-g") )
( INST_cy_SPKR_diphone_1989	"sil @ xx d a v - f a d sil"	("v-f") )
( INST_cy_SPKR_diphone_1990	"sil @ xx d a v - v a d sil"	("v-v") )
( INST_cy_SPKR_diphone_1991	"sil @ xx d a v - th a d sil"	("v-th") )
( INST_cy_SPKR_diphone_1992	"sil @ xx d a v - dh a d sil"	("v-dh") )
( INST_cy_SPKR_diphone_1993	"sil @ xx d a v - s a d sil"	("v-s") )
( INST_cy_SPKR_diphone_1994	"sil @ xx d a v - sh a d sil"	("v-sh") )
( INST_cy_SPKR_diphone_1995	"sil @ xx d a v - r a d sil"	("v-r") )
( INST_cy_SPKR_diphone_1996	"sil @ xx d a v - l a d sil"	("v-l") )
( INST_cy_SPKR_diphone_1997	"sil @ xx d a v - m a d sil"	("v-m") )
( INST_cy_SPKR_diphone_1998	"sil @ xx d a v - n a d sil"	("v-n") )
( INST_cy_SPKR_diphone_1999	"sil @ xx d a v - ng a d sil"	("v-ng") )
( INST_cy_SPKR_diphone_2000	"sil @ xx d a v - ch a d sil"	("v-ch") )
( INST_cy_SPKR_diphone_2001	"sil @ xx d a v - jh a d sil"	("v-jh") )
( INST_cy_SPKR_diphone_2002	"sil @ xx d a v - lh a d sil"	("v-lh") )
( INST_cy_SPKR_diphone_2003	"sil @ xx d a v - x a d sil"	("v-x") )
( INST_cy_SPKR_diphone_2004	"sil @ xx d a v - w a d sil"	("v-w") )
( INST_cy_SPKR_diphone_2005	"sil @ xx d a v - j a d sil"	("v-j") )
( INST_cy_SPKR_diphone_2006	"sil @ xx d a v - mh a d sil"	("v-mh") )
( INST_cy_SPKR_diphone_2007	"sil @ xx d a v - nh a d sil"	("v-nh") )
( INST_cy_SPKR_diphone_2008	"sil @ xx d a v - ngh a d sil"	("v-ngh") )
( INST_cy_SPKR_diphone_2009	"sil @ xx d a v - lw a d sil"	("v-lw") )
( INST_cy_SPKR_diphone_2010	"sil @ xx d a v - nw a d sil"	("v-nw") )
( INST_cy_SPKR_diphone_2011	"sil @ xx d a v - rw a d sil"	("v-rw") )
( INST_cy_SPKR_diphone_2012	"sil @ xx d a v - rh a d sil"	("v-rh") )
( INST_cy_SPKR_diphone_2013	"sil @ xx d a v - hh a d sil"	("v-hh") )
( INST_cy_SPKR_diphone_2014	"sil @ xx d a v - z a d sil"	("v-z") )
( INST_cy_SPKR_diphone_2015	"sil @ xx d a th - p a d sil"	("th-p") )
( INST_cy_SPKR_diphone_2016	"sil @ xx d a th - t a d sil"	("th-t") )
( INST_cy_SPKR_diphone_2017	"sil @ xx d a th - k a d sil"	("th-k") )
( INST_cy_SPKR_diphone_2018	"sil @ xx d a th - b a d sil"	("th-b") )
( INST_cy_SPKR_diphone_2019	"sil @ xx d a th - d a d sil"	("th-d") )
( INST_cy_SPKR_diphone_2020	"sil @ xx d a th - g a d sil"	("th-g") )
( INST_cy_SPKR_diphone_2021	"sil @ xx d a th - f a d sil"	("th-f") )
( INST_cy_SPKR_diphone_2022	"sil @ xx d a th - v a d sil"	("th-v") )
( INST_cy_SPKR_diphone_2023	"sil @ xx d a th - th a d sil"	("th-th") )
( INST_cy_SPKR_diphone_2024	"sil @ xx d a th - dh a d sil"	("th-dh") )
( INST_cy_SPKR_diphone_2025	"sil @ xx d a th - s a d sil"	("th-s") )
( INST_cy_SPKR_diphone_2026	"sil @ xx d a th - sh a d sil"	("th-sh") )
( INST_cy_SPKR_diphone_2027	"sil @ xx d a th - r a d sil"	("th-r") )
( INST_cy_SPKR_diphone_2028	"sil @ xx d a th - l a d sil"	("th-l") )
( INST_cy_SPKR_diphone_2029	"sil @ xx d a th - m a d sil"	("th-m") )
( INST_cy_SPKR_diphone_2030	"sil @ xx d a th - n a d sil"	("th-n") )
( INST_cy_SPKR_diphone_2031	"sil @ xx d a th - ng a d sil"	("th-ng") )
( INST_cy_SPKR_diphone_2032	"sil @ xx d a th - ch a d sil"	("th-ch") )
( INST_cy_SPKR_diphone_2033	"sil @ xx d a th - jh a d sil"	("th-jh") )
( INST_cy_SPKR_diphone_2034	"sil @ xx d a th - lh a d sil"	("th-lh") )
( INST_cy_SPKR_diphone_2035	"sil @ xx d a th - x a d sil"	("th-x") )
( INST_cy_SPKR_diphone_2036	"sil @ xx d a th - w a d sil"	("th-w") )
( INST_cy_SPKR_diphone_2037	"sil @ xx d a th - j a d sil"	("th-j") )
( INST_cy_SPKR_diphone_2038	"sil @ xx d a th - mh a d sil"	("th-mh") )
( INST_cy_SPKR_diphone_2039	"sil @ xx d a th - nh a d sil"	("th-nh") )
( INST_cy_SPKR_diphone_2040	"sil @ xx d a th - ngh a d sil"	("th-ngh") )
( INST_cy_SPKR_diphone_2041	"sil @ xx d a th - lw a d sil"	("th-lw") )
( INST_cy_SPKR_diphone_2042	"sil @ xx d a th - nw a d sil"	("th-nw") )
( INST_cy_SPKR_diphone_2043	"sil @ xx d a th - rw a d sil"	("th-rw") )
( INST_cy_SPKR_diphone_2044	"sil @ xx d a th - rh a d sil"	("th-rh") )
( INST_cy_SPKR_diphone_2045	"sil @ xx d a th - hh a d sil"	("th-hh") )
( INST_cy_SPKR_diphone_2046	"sil @ xx d a th - z a d sil"	("th-z") )
( INST_cy_SPKR_diphone_2047	"sil @ xx d a dh - p a d sil"	("dh-p") )
( INST_cy_SPKR_diphone_2048	"sil @ xx d a dh - t a d sil"	("dh-t") )
( INST_cy_SPKR_diphone_2049	"sil @ xx d a dh - k a d sil"	("dh-k") )
( INST_cy_SPKR_diphone_2050	"sil @ xx d a dh - b a d sil"	("dh-b") )
( INST_cy_SPKR_diphone_2051	"sil @ xx d a dh - d a d sil"	("dh-d") )
( INST_cy_SPKR_diphone_2052	"sil @ xx d a dh - g a d sil"	("dh-g") )
( INST_cy_SPKR_diphone_2053	"sil @ xx d a dh - f a d sil"	("dh-f") )
( INST_cy_SPKR_diphone_2054	"sil @ xx d a dh - v a d sil"	("dh-v") )
( INST_cy_SPKR_diphone_2055	"sil @ xx d a dh - th a d sil"	("dh-th") )
( INST_cy_SPKR_diphone_2056	"sil @ xx d a dh - dh a d sil"	("dh-dh") )
( INST_cy_SPKR_diphone_2057	"sil @ xx d a dh - s a d sil"	("dh-s") )
( INST_cy_SPKR_diphone_2058	"sil @ xx d a dh - sh a d sil"	("dh-sh") )
( INST_cy_SPKR_diphone_2059	"sil @ xx d a dh - r a d sil"	("dh-r") )
( INST_cy_SPKR_diphone_2060	"sil @ xx d a dh - l a d sil"	("dh-l") )
( INST_cy_SPKR_diphone_2061	"sil @ xx d a dh - m a d sil"	("dh-m") )
( INST_cy_SPKR_diphone_2062	"sil @ xx d a dh - n a d sil"	("dh-n") )
( INST_cy_SPKR_diphone_2063	"sil @ xx d a dh - ng a d sil"	("dh-ng") )
( INST_cy_SPKR_diphone_2064	"sil @ xx d a dh - ch a d sil"	("dh-ch") )
( INST_cy_SPKR_diphone_2065	"sil @ xx d a dh - jh a d sil"	("dh-jh") )
( INST_cy_SPKR_diphone_2066	"sil @ xx d a dh - lh a d sil"	("dh-lh") )
( INST_cy_SPKR_diphone_2067	"sil @ xx d a dh - x a d sil"	("dh-x") )
( INST_cy_SPKR_diphone_2068	"sil @ xx d a dh - w a d sil"	("dh-w") )
( INST_cy_SPKR_diphone_2069	"sil @ xx d a dh - j a d sil"	("dh-j") )
( INST_cy_SPKR_diphone_2070	"sil @ xx d a dh - mh a d sil"	("dh-mh") )
( INST_cy_SPKR_diphone_2071	"sil @ xx d a dh - nh a d sil"	("dh-nh") )
( INST_cy_SPKR_diphone_2072	"sil @ xx d a dh - ngh a d sil"	("dh-ngh") )
( INST_cy_SPKR_diphone_2073	"sil @ xx d a dh - lw a d sil"	("dh-lw") )
( INST_cy_SPKR_diphone_2074	"sil @ xx d a dh - nw a d sil"	("dh-nw") )
( INST_cy_SPKR_diphone_2075	"sil @ xx d a dh - rw a d sil"	("dh-rw") )
( INST_cy_SPKR_diphone_2076	"sil @ xx d a dh - rh a d sil"	("dh-rh") )
( INST_cy_SPKR_diphone_2077	"sil @ xx d a dh - hh a d sil"	("dh-hh") )
( INST_cy_SPKR_diphone_2078	"sil @ xx d a dh - z a d sil"	("dh-z") )
( INST_cy_SPKR_diphone_2079	"sil @ xx d a s - p a d sil"	("s-p") )
( INST_cy_SPKR_diphone_2080	"sil @ xx d a s - t a d sil"	("s-t") )
( INST_cy_SPKR_diphone_2081	"sil @ xx d a s - k a d sil"	("s-k") )
( INST_cy_SPKR_diphone_2082	"sil @ xx d a s - b a d sil"	("s-b") )
( INST_cy_SPKR_diphone_2083	"sil @ xx d a s - d a d sil"	("s-d") )
( INST_cy_SPKR_diphone_2084	"sil @ xx d a s - g a d sil"	("s-g") )
( INST_cy_SPKR_diphone_2085	"sil @ xx d a s - f a d sil"	("s-f") )
( INST_cy_SPKR_diphone_2086	"sil @ xx d a s - v a d sil"	("s-v") )
( INST_cy_SPKR_diphone_2087	"sil @ xx d a s - th a d sil"	("s-th") )
( INST_cy_SPKR_diphone_2088	"sil @ xx d a s - dh a d sil"	("s-dh") )
( INST_cy_SPKR_diphone_2089	"sil @ xx d a s - s a d sil"	("s-s") )
( INST_cy_SPKR_diphone_2090	"sil @ xx d a s - sh a d sil"	("s-sh") )
( INST_cy_SPKR_diphone_2091	"sil @ xx d a s - r a d sil"	("s-r") )
( INST_cy_SPKR_diphone_2092	"sil @ xx d a s - l a d sil"	("s-l") )
( INST_cy_SPKR_diphone_2093	"sil @ xx d a s - m a d sil"	("s-m") )
( INST_cy_SPKR_diphone_2094	"sil @ xx d a s - n a d sil"	("s-n") )
( INST_cy_SPKR_diphone_2095	"sil @ xx d a s - ng a d sil"	("s-ng") )
( INST_cy_SPKR_diphone_2096	"sil @ xx d a s - ch a d sil"	("s-ch") )
( INST_cy_SPKR_diphone_2097	"sil @ xx d a s - jh a d sil"	("s-jh") )
( INST_cy_SPKR_diphone_2098	"sil @ xx d a s - lh a d sil"	("s-lh") )
( INST_cy_SPKR_diphone_2099	"sil @ xx d a s - x a d sil"	("s-x") )
( INST_cy_SPKR_diphone_2100	"sil @ xx d a s - w a d sil"	("s-w") )
( INST_cy_SPKR_diphone_2101	"sil @ xx d a s - j a d sil"	("s-j") )
( INST_cy_SPKR_diphone_2102	"sil @ xx d a s - mh a d sil"	("s-mh") )
( INST_cy_SPKR_diphone_2103	"sil @ xx d a s - nh a d sil"	("s-nh") )
( INST_cy_SPKR_diphone_2104	"sil @ xx d a s - ngh a d sil"	("s-ngh") )
( INST_cy_SPKR_diphone_2105	"sil @ xx d a s - lw a d sil"	("s-lw") )
( INST_cy_SPKR_diphone_2106	"sil @ xx d a s - nw a d sil"	("s-nw") )
( INST_cy_SPKR_diphone_2107	"sil @ xx d a s - rw a d sil"	("s-rw") )
( INST_cy_SPKR_diphone_2108	"sil @ xx d a s - rh a d sil"	("s-rh") )
( INST_cy_SPKR_diphone_2109	"sil @ xx d a s - hh a d sil"	("s-hh") )
( INST_cy_SPKR_diphone_2110	"sil @ xx d a s - z a d sil"	("s-z") )
( INST_cy_SPKR_diphone_2111	"sil @ xx d a sh - p a d sil"	("sh-p") )
( INST_cy_SPKR_diphone_2112	"sil @ xx d a sh - t a d sil"	("sh-t") )
( INST_cy_SPKR_diphone_2113	"sil @ xx d a sh - k a d sil"	("sh-k") )
( INST_cy_SPKR_diphone_2114	"sil @ xx d a sh - b a d sil"	("sh-b") )
( INST_cy_SPKR_diphone_2115	"sil @ xx d a sh - d a d sil"	("sh-d") )
( INST_cy_SPKR_diphone_2116	"sil @ xx d a sh - g a d sil"	("sh-g") )
( INST_cy_SPKR_diphone_2117	"sil @ xx d a sh - f a d sil"	("sh-f") )
( INST_cy_SPKR_diphone_2118	"sil @ xx d a sh - v a d sil"	("sh-v") )
( INST_cy_SPKR_diphone_2119	"sil @ xx d a sh - th a d sil"	("sh-th") )
( INST_cy_SPKR_diphone_2120	"sil @ xx d a sh - dh a d sil"	("sh-dh") )
( INST_cy_SPKR_diphone_2121	"sil @ xx d a sh - s a d sil"	("sh-s") )
( INST_cy_SPKR_diphone_2122	"sil @ xx d a sh - sh a d sil"	("sh-sh") )
( INST_cy_SPKR_diphone_2123	"sil @ xx d a sh - r a d sil"	("sh-r") )
( INST_cy_SPKR_diphone_2124	"sil @ xx d a sh - l a d sil"	("sh-l") )
( INST_cy_SPKR_diphone_2125	"sil @ xx d a sh - m a d sil"	("sh-m") )
( INST_cy_SPKR_diphone_2126	"sil @ xx d a sh - n a d sil"	("sh-n") )
( INST_cy_SPKR_diphone_2127	"sil @ xx d a sh - ng a d sil"	("sh-ng") )
( INST_cy_SPKR_diphone_2128	"sil @ xx d a sh - ch a d sil"	("sh-ch") )
( INST_cy_SPKR_diphone_2129	"sil @ xx d a sh - jh a d sil"	("sh-jh") )
( INST_cy_SPKR_diphone_2130	"sil @ xx d a sh - lh a d sil"	("sh-lh") )
( INST_cy_SPKR_diphone_2131	"sil @ xx d a sh - x a d sil"	("sh-x") )
( INST_cy_SPKR_diphone_2132	"sil @ xx d a sh - w a d sil"	("sh-w") )
( INST_cy_SPKR_diphone_2133	"sil @ xx d a sh - j a d sil"	("sh-j") )
( INST_cy_SPKR_diphone_2134	"sil @ xx d a sh - mh a d sil"	("sh-mh") )
( INST_cy_SPKR_diphone_2135	"sil @ xx d a sh - nh a d sil"	("sh-nh") )
( INST_cy_SPKR_diphone_2136	"sil @ xx d a sh - ngh a d sil"	("sh-ngh") )
( INST_cy_SPKR_diphone_2137	"sil @ xx d a sh - lw a d sil"	("sh-lw") )
( INST_cy_SPKR_diphone_2138	"sil @ xx d a sh - nw a d sil"	("sh-nw") )
( INST_cy_SPKR_diphone_2139	"sil @ xx d a sh - rw a d sil"	("sh-rw") )
( INST_cy_SPKR_diphone_2140	"sil @ xx d a sh - rh a d sil"	("sh-rh") )
( INST_cy_SPKR_diphone_2141	"sil @ xx d a sh - hh a d sil"	("sh-hh") )
( INST_cy_SPKR_diphone_2142	"sil @ xx d a sh - z a d sil"	("sh-z") )
( INST_cy_SPKR_diphone_2143	"sil @ xx d a r - p a d sil"	("r-p") )
( INST_cy_SPKR_diphone_2144	"sil @ xx d a r - t a d sil"	("r-t") )
( INST_cy_SPKR_diphone_2145	"sil @ xx d a r - k a d sil"	("r-k") )
( INST_cy_SPKR_diphone_2146	"sil @ xx d a r - b a d sil"	("r-b") )
( INST_cy_SPKR_diphone_2147	"sil @ xx d a r - d a d sil"	("r-d") )
( INST_cy_SPKR_diphone_2148	"sil @ xx d a r - g a d sil"	("r-g") )
( INST_cy_SPKR_diphone_2149	"sil @ xx d a r - f a d sil"	("r-f") )
( INST_cy_SPKR_diphone_2150	"sil @ xx d a r - v a d sil"	("r-v") )
( INST_cy_SPKR_diphone_2151	"sil @ xx d a r - th a d sil"	("r-th") )
( INST_cy_SPKR_diphone_2152	"sil @ xx d a r - dh a d sil"	("r-dh") )
( INST_cy_SPKR_diphone_2153	"sil @ xx d a r - s a d sil"	("r-s") )
( INST_cy_SPKR_diphone_2154	"sil @ xx d a r - sh a d sil"	("r-sh") )
( INST_cy_SPKR_diphone_2155	"sil @ xx d a r - r a d sil"	("r-r") )
( INST_cy_SPKR_diphone_2156	"sil @ xx d a r - l a d sil"	("r-l") )
( INST_cy_SPKR_diphone_2157	"sil @ xx d a r - m a d sil"	("r-m") )
( INST_cy_SPKR_diphone_2158	"sil @ xx d a r - n a d sil"	("r-n") )
( INST_cy_SPKR_diphone_2159	"sil @ xx d a r - ng a d sil"	("r-ng") )
( INST_cy_SPKR_diphone_2160	"sil @ xx d a r - ch a d sil"	("r-ch") )
( INST_cy_SPKR_diphone_2161	"sil @ xx d a r - jh a d sil"	("r-jh") )
( INST_cy_SPKR_diphone_2162	"sil @ xx d a r - lh a d sil"	("r-lh") )
( INST_cy_SPKR_diphone_2163	"sil @ xx d a r - x a d sil"	("r-x") )
( INST_cy_SPKR_diphone_2164	"sil @ xx d a r - w a d sil"	("r-w") )
( INST_cy_SPKR_diphone_2165	"sil @ xx d a r - j a d sil"	("r-j") )
( INST_cy_SPKR_diphone_2166	"sil @ xx d a r - mh a d sil"	("r-mh") )
( INST_cy_SPKR_diphone_2167	"sil @ xx d a r - nh a d sil"	("r-nh") )
( INST_cy_SPKR_diphone_2168	"sil @ xx d a r - ngh a d sil"	("r-ngh") )
( INST_cy_SPKR_diphone_2169	"sil @ xx d a r - lw a d sil"	("r-lw") )
( INST_cy_SPKR_diphone_2170	"sil @ xx d a r - nw a d sil"	("r-nw") )
( INST_cy_SPKR_diphone_2171	"sil @ xx d a r - rw a d sil"	("r-rw") )
( INST_cy_SPKR_diphone_2172	"sil @ xx d a r - rh a d sil"	("r-rh") )
( INST_cy_SPKR_diphone_2173	"sil @ xx d a r - hh a d sil"	("r-hh") )
( INST_cy_SPKR_diphone_2174	"sil @ xx d a r - z a d sil"	("r-z") )
( INST_cy_SPKR_diphone_2175	"sil @ xx d a l - p a d sil"	("l-p") )
( INST_cy_SPKR_diphone_2176	"sil @ xx d a l - t a d sil"	("l-t") )
( INST_cy_SPKR_diphone_2177	"sil @ xx d a l - k a d sil"	("l-k") )
( INST_cy_SPKR_diphone_2178	"sil @ xx d a l - b a d sil"	("l-b") )
( INST_cy_SPKR_diphone_2179	"sil @ xx d a l - d a d sil"	("l-d") )
( INST_cy_SPKR_diphone_2180	"sil @ xx d a l - g a d sil"	("l-g") )
( INST_cy_SPKR_diphone_2181	"sil @ xx d a l - f a d sil"	("l-f") )
( INST_cy_SPKR_diphone_2182	"sil @ xx d a l - v a d sil"	("l-v") )
( INST_cy_SPKR_diphone_2183	"sil @ xx d a l - th a d sil"	("l-th") )
( INST_cy_SPKR_diphone_2184	"sil @ xx d a l - dh a d sil"	("l-dh") )
( INST_cy_SPKR_diphone_2185	"sil @ xx d a l - s a d sil"	("l-s") )
( INST_cy_SPKR_diphone_2186	"sil @ xx d a l - sh a d sil"	("l-sh") )
( INST_cy_SPKR_diphone_2187	"sil @ xx d a l - r a d sil"	("l-r") )
( INST_cy_SPKR_diphone_2188	"sil @ xx d a l - l a d sil"	("l-l") )
( INST_cy_SPKR_diphone_2189	"sil @ xx d a l - m a d sil"	("l-m") )
( INST_cy_SPKR_diphone_2190	"sil @ xx d a l - n a d sil"	("l-n") )
( INST_cy_SPKR_diphone_2191	"sil @ xx d a l - ng a d sil"	("l-ng") )
( INST_cy_SPKR_diphone_2192	"sil @ xx d a l - ch a d sil"	("l-ch") )
( INST_cy_SPKR_diphone_2193	"sil @ xx d a l - jh a d sil"	("l-jh") )
( INST_cy_SPKR_diphone_2194	"sil @ xx d a l - lh a d sil"	("l-lh") )
( INST_cy_SPKR_diphone_2195	"sil @ xx d a l - x a d sil"	("l-x") )
( INST_cy_SPKR_diphone_2196	"sil @ xx d a l - w a d sil"	("l-w") )
( INST_cy_SPKR_diphone_2197	"sil @ xx d a l - j a d sil"	("l-j") )
( INST_cy_SPKR_diphone_2198	"sil @ xx d a l - mh a d sil"	("l-mh") )
( INST_cy_SPKR_diphone_2199	"sil @ xx d a l - nh a d sil"	("l-nh") )
( INST_cy_SPKR_diphone_2200	"sil @ xx d a l - ngh a d sil"	("l-ngh") )
( INST_cy_SPKR_diphone_2201	"sil @ xx d a l - lw a d sil"	("l-lw") )
( INST_cy_SPKR_diphone_2202	"sil @ xx d a l - nw a d sil"	("l-nw") )
( INST_cy_SPKR_diphone_2203	"sil @ xx d a l - rw a d sil"	("l-rw") )
( INST_cy_SPKR_diphone_2204	"sil @ xx d a l - rh a d sil"	("l-rh") )
( INST_cy_SPKR_diphone_2205	"sil @ xx d a l - hh a d sil"	("l-hh") )
( INST_cy_SPKR_diphone_2206	"sil @ xx d a l - z a d sil"	("l-z") )
( INST_cy_SPKR_diphone_2207	"sil @ xx d a m - p a d sil"	("m-p") )
( INST_cy_SPKR_diphone_2208	"sil @ xx d a m - t a d sil"	("m-t") )
( INST_cy_SPKR_diphone_2209	"sil @ xx d a m - k a d sil"	("m-k") )
( INST_cy_SPKR_diphone_2210	"sil @ xx d a m - b a d sil"	("m-b") )
( INST_cy_SPKR_diphone_2211	"sil @ xx d a m - d a d sil"	("m-d") )
( INST_cy_SPKR_diphone_2212	"sil @ xx d a m - g a d sil"	("m-g") )
( INST_cy_SPKR_diphone_2213	"sil @ xx d a m - f a d sil"	("m-f") )
( INST_cy_SPKR_diphone_2214	"sil @ xx d a m - v a d sil"	("m-v") )
( INST_cy_SPKR_diphone_2215	"sil @ xx d a m - th a d sil"	("m-th") )
( INST_cy_SPKR_diphone_2216	"sil @ xx d a m - dh a d sil"	("m-dh") )
( INST_cy_SPKR_diphone_2217	"sil @ xx d a m - s a d sil"	("m-s") )
( INST_cy_SPKR_diphone_2218	"sil @ xx d a m - sh a d sil"	("m-sh") )
( INST_cy_SPKR_diphone_2219	"sil @ xx d a m - r a d sil"	("m-r") )
( INST_cy_SPKR_diphone_2220	"sil @ xx d a m - l a d sil"	("m-l") )
( INST_cy_SPKR_diphone_2221	"sil @ xx d a m - m a d sil"	("m-m") )
( INST_cy_SPKR_diphone_2222	"sil @ xx d a m - n a d sil"	("m-n") )
( INST_cy_SPKR_diphone_2223	"sil @ xx d a m - ng a d sil"	("m-ng") )
( INST_cy_SPKR_diphone_2224	"sil @ xx d a m - ch a d sil"	("m-ch") )
( INST_cy_SPKR_diphone_2225	"sil @ xx d a m - jh a d sil"	("m-jh") )
( INST_cy_SPKR_diphone_2226	"sil @ xx d a m - lh a d sil"	("m-lh") )
( INST_cy_SPKR_diphone_2227	"sil @ xx d a m - x a d sil"	("m-x") )
( INST_cy_SPKR_diphone_2228	"sil @ xx d a m - w a d sil"	("m-w") )
( INST_cy_SPKR_diphone_2229	"sil @ xx d a m - j a d sil"	("m-j") )
( INST_cy_SPKR_diphone_2230	"sil @ xx d a m - mh a d sil"	("m-mh") )
( INST_cy_SPKR_diphone_2231	"sil @ xx d a m - nh a d sil"	("m-nh") )
( INST_cy_SPKR_diphone_2232	"sil @ xx d a m - ngh a d sil"	("m-ngh") )
( INST_cy_SPKR_diphone_2233	"sil @ xx d a m - lw a d sil"	("m-lw") )
( INST_cy_SPKR_diphone_2234	"sil @ xx d a m - nw a d sil"	("m-nw") )
( INST_cy_SPKR_diphone_2235	"sil @ xx d a m - rw a d sil"	("m-rw") )
( INST_cy_SPKR_diphone_2236	"sil @ xx d a m - rh a d sil"	("m-rh") )
( INST_cy_SPKR_diphone_2237	"sil @ xx d a m - hh a d sil"	("m-hh") )
( INST_cy_SPKR_diphone_2238	"sil @ xx d a m - z a d sil"	("m-z") )
( INST_cy_SPKR_diphone_2239	"sil @ xx d a n - p a d sil"	("n-p") )
( INST_cy_SPKR_diphone_2240	"sil @ xx d a n - t a d sil"	("n-t") )
( INST_cy_SPKR_diphone_2241	"sil @ xx d a n - k a d sil"	("n-k") )
( INST_cy_SPKR_diphone_2242	"sil @ xx d a n - b a d sil"	("n-b") )
( INST_cy_SPKR_diphone_2243	"sil @ xx d a n - d a d sil"	("n-d") )
( INST_cy_SPKR_diphone_2244	"sil @ xx d a n - g a d sil"	("n-g") )
( INST_cy_SPKR_diphone_2245	"sil @ xx d a n - f a d sil"	("n-f") )
( INST_cy_SPKR_diphone_2246	"sil @ xx d a n - v a d sil"	("n-v") )
( INST_cy_SPKR_diphone_2247	"sil @ xx d a n - th a d sil"	("n-th") )
( INST_cy_SPKR_diphone_2248	"sil @ xx d a n - dh a d sil"	("n-dh") )
( INST_cy_SPKR_diphone_2249	"sil @ xx d a n - s a d sil"	("n-s") )
( INST_cy_SPKR_diphone_2250	"sil @ xx d a n - sh a d sil"	("n-sh") )
( INST_cy_SPKR_diphone_2251	"sil @ xx d a n - r a d sil"	("n-r") )
( INST_cy_SPKR_diphone_2252	"sil @ xx d a n - l a d sil"	("n-l") )
( INST_cy_SPKR_diphone_2253	"sil @ xx d a n - m a d sil"	("n-m") )
( INST_cy_SPKR_diphone_2254	"sil @ xx d a n - n a d sil"	("n-n") )
( INST_cy_SPKR_diphone_2255	"sil @ xx d a n - ng a d sil"	("n-ng") )
( INST_cy_SPKR_diphone_2256	"sil @ xx d a n - ch a d sil"	("n-ch") )
( INST_cy_SPKR_diphone_2257	"sil @ xx d a n - jh a d sil"	("n-jh") )
( INST_cy_SPKR_diphone_2258	"sil @ xx d a n - lh a d sil"	("n-lh") )
( INST_cy_SPKR_diphone_2259	"sil @ xx d a n - x a d sil"	("n-x") )
( INST_cy_SPKR_diphone_2260	"sil @ xx d a n - w a d sil"	("n-w") )
( INST_cy_SPKR_diphone_2261	"sil @ xx d a n - j a d sil"	("n-j") )
( INST_cy_SPKR_diphone_2262	"sil @ xx d a n - mh a d sil"	("n-mh") )
( INST_cy_SPKR_diphone_2263	"sil @ xx d a n - nh a d sil"	("n-nh") )
( INST_cy_SPKR_diphone_2264	"sil @ xx d a n - ngh a d sil"	("n-ngh") )
( INST_cy_SPKR_diphone_2265	"sil @ xx d a n - lw a d sil"	("n-lw") )
( INST_cy_SPKR_diphone_2266	"sil @ xx d a n - nw a d sil"	("n-nw") )
( INST_cy_SPKR_diphone_2267	"sil @ xx d a n - rw a d sil"	("n-rw") )
( INST_cy_SPKR_diphone_2268	"sil @ xx d a n - rh a d sil"	("n-rh") )
( INST_cy_SPKR_diphone_2269	"sil @ xx d a n - hh a d sil"	("n-hh") )
( INST_cy_SPKR_diphone_2270	"sil @ xx d a n - z a d sil"	("n-z") )
( INST_cy_SPKR_diphone_2271	"sil @ xx d a ng - p a d sil"	("ng-p") )
( INST_cy_SPKR_diphone_2272	"sil @ xx d a ng - t a d sil"	("ng-t") )
( INST_cy_SPKR_diphone_2273	"sil @ xx d a ng - k a d sil"	("ng-k") )
( INST_cy_SPKR_diphone_2274	"sil @ xx d a ng - b a d sil"	("ng-b") )
( INST_cy_SPKR_diphone_2275	"sil @ xx d a ng - d a d sil"	("ng-d") )
( INST_cy_SPKR_diphone_2276	"sil @ xx d a ng - g a d sil"	("ng-g") )
( INST_cy_SPKR_diphone_2277	"sil @ xx d a ng - f a d sil"	("ng-f") )
( INST_cy_SPKR_diphone_2278	"sil @ xx d a ng - v a d sil"	("ng-v") )
( INST_cy_SPKR_diphone_2279	"sil @ xx d a ng - th a d sil"	("ng-th") )
( INST_cy_SPKR_diphone_2280	"sil @ xx d a ng - dh a d sil"	("ng-dh") )
( INST_cy_SPKR_diphone_2281	"sil @ xx d a ng - s a d sil"	("ng-s") )
( INST_cy_SPKR_diphone_2282	"sil @ xx d a ng - sh a d sil"	("ng-sh") )
( INST_cy_SPKR_diphone_2283	"sil @ xx d a ng - r a d sil"	("ng-r") )
( INST_cy_SPKR_diphone_2284	"sil @ xx d a ng - l a d sil"	("ng-l") )
( INST_cy_SPKR_diphone_2285	"sil @ xx d a ng - m a d sil"	("ng-m") )
( INST_cy_SPKR_diphone_2286	"sil @ xx d a ng - n a d sil"	("ng-n") )
( INST_cy_SPKR_diphone_2287	"sil @ xx d a ng - ng a d sil"	("ng-ng") )
( INST_cy_SPKR_diphone_2288	"sil @ xx d a ng - ch a d sil"	("ng-ch") )
( INST_cy_SPKR_diphone_2289	"sil @ xx d a ng - jh a d sil"	("ng-jh") )
( INST_cy_SPKR_diphone_2290	"sil @ xx d a ng - lh a d sil"	("ng-lh") )
( INST_cy_SPKR_diphone_2291	"sil @ xx d a ng - x a d sil"	("ng-x") )
( INST_cy_SPKR_diphone_2292	"sil @ xx d a ng - w a d sil"	("ng-w") )
( INST_cy_SPKR_diphone_2293	"sil @ xx d a ng - j a d sil"	("ng-j") )
( INST_cy_SPKR_diphone_2294	"sil @ xx d a ng - mh a d sil"	("ng-mh") )
( INST_cy_SPKR_diphone_2295	"sil @ xx d a ng - nh a d sil"	("ng-nh") )
( INST_cy_SPKR_diphone_2296	"sil @ xx d a ng - ngh a d sil"	("ng-ngh") )
( INST_cy_SPKR_diphone_2297	"sil @ xx d a ng - lw a d sil"	("ng-lw") )
( INST_cy_SPKR_diphone_2298	"sil @ xx d a ng - nw a d sil"	("ng-nw") )
( INST_cy_SPKR_diphone_2299	"sil @ xx d a ng - rw a d sil"	("ng-rw") )
( INST_cy_SPKR_diphone_2300	"sil @ xx d a ng - rh a d sil"	("ng-rh") )
( INST_cy_SPKR_diphone_2301	"sil @ xx d a ng - hh a d sil"	("ng-hh") )
( INST_cy_SPKR_diphone_2302	"sil @ xx d a ng - z a d sil"	("ng-z") )
( INST_cy_SPKR_diphone_2303	"sil @ xx d a ch - p a d sil"	("ch-p") )
( INST_cy_SPKR_diphone_2304	"sil @ xx d a ch - t a d sil"	("ch-t") )
( INST_cy_SPKR_diphone_2305	"sil @ xx d a ch - k a d sil"	("ch-k") )
( INST_cy_SPKR_diphone_2306	"sil @ xx d a ch - b a d sil"	("ch-b") )
( INST_cy_SPKR_diphone_2307	"sil @ xx d a ch - d a d sil"	("ch-d") )
( INST_cy_SPKR_diphone_2308	"sil @ xx d a ch - g a d sil"	("ch-g") )
( INST_cy_SPKR_diphone_2309	"sil @ xx d a ch - f a d sil"	("ch-f") )
( INST_cy_SPKR_diphone_2310	"sil @ xx d a ch - v a d sil"	("ch-v") )
( INST_cy_SPKR_diphone_2311	"sil @ xx d a ch - th a d sil"	("ch-th") )
( INST_cy_SPKR_diphone_2312	"sil @ xx d a ch - dh a d sil"	("ch-dh") )
( INST_cy_SPKR_diphone_2313	"sil @ xx d a ch - s a d sil"	("ch-s") )
( INST_cy_SPKR_diphone_2314	"sil @ xx d a ch - sh a d sil"	("ch-sh") )
( INST_cy_SPKR_diphone_2315	"sil @ xx d a ch - r a d sil"	("ch-r") )
( INST_cy_SPKR_diphone_2316	"sil @ xx d a ch - l a d sil"	("ch-l") )
( INST_cy_SPKR_diphone_2317	"sil @ xx d a ch - m a d sil"	("ch-m") )
( INST_cy_SPKR_diphone_2318	"sil @ xx d a ch - n a d sil"	("ch-n") )
( INST_cy_SPKR_diphone_2319	"sil @ xx d a ch - ng a d sil"	("ch-ng") )
( INST_cy_SPKR_diphone_2320	"sil @ xx d a ch - ch a d sil"	("ch-ch") )
( INST_cy_SPKR_diphone_2321	"sil @ xx d a ch - jh a d sil"	("ch-jh") )
( INST_cy_SPKR_diphone_2322	"sil @ xx d a ch - lh a d sil"	("ch-lh") )
( INST_cy_SPKR_diphone_2323	"sil @ xx d a ch - x a d sil"	("ch-x") )
( INST_cy_SPKR_diphone_2324	"sil @ xx d a ch - w a d sil"	("ch-w") )
( INST_cy_SPKR_diphone_2325	"sil @ xx d a ch - j a d sil"	("ch-j") )
( INST_cy_SPKR_diphone_2326	"sil @ xx d a ch - mh a d sil"	("ch-mh") )
( INST_cy_SPKR_diphone_2327	"sil @ xx d a ch - nh a d sil"	("ch-nh") )
( INST_cy_SPKR_diphone_2328	"sil @ xx d a ch - ngh a d sil"	("ch-ngh") )
( INST_cy_SPKR_diphone_2329	"sil @ xx d a ch - lw a d sil"	("ch-lw") )
( INST_cy_SPKR_diphone_2330	"sil @ xx d a ch - nw a d sil"	("ch-nw") )
( INST_cy_SPKR_diphone_2331	"sil @ xx d a ch - rw a d sil"	("ch-rw") )
( INST_cy_SPKR_diphone_2332	"sil @ xx d a ch - rh a d sil"	("ch-rh") )
( INST_cy_SPKR_diphone_2333	"sil @ xx d a ch - hh a d sil"	("ch-hh") )
( INST_cy_SPKR_diphone_2334	"sil @ xx d a ch - z a d sil"	("ch-z") )
( INST_cy_SPKR_diphone_2335	"sil @ xx d a jh - p a d sil"	("jh-p") )
( INST_cy_SPKR_diphone_2336	"sil @ xx d a jh - t a d sil"	("jh-t") )
( INST_cy_SPKR_diphone_2337	"sil @ xx d a jh - k a d sil"	("jh-k") )
( INST_cy_SPKR_diphone_2338	"sil @ xx d a jh - b a d sil"	("jh-b") )
( INST_cy_SPKR_diphone_2339	"sil @ xx d a jh - d a d sil"	("jh-d") )
( INST_cy_SPKR_diphone_2340	"sil @ xx d a jh - g a d sil"	("jh-g") )
( INST_cy_SPKR_diphone_2341	"sil @ xx d a jh - f a d sil"	("jh-f") )
( INST_cy_SPKR_diphone_2342	"sil @ xx d a jh - v a d sil"	("jh-v") )
( INST_cy_SPKR_diphone_2343	"sil @ xx d a jh - th a d sil"	("jh-th") )
( INST_cy_SPKR_diphone_2344	"sil @ xx d a jh - dh a d sil"	("jh-dh") )
( INST_cy_SPKR_diphone_2345	"sil @ xx d a jh - s a d sil"	("jh-s") )
( INST_cy_SPKR_diphone_2346	"sil @ xx d a jh - sh a d sil"	("jh-sh") )
( INST_cy_SPKR_diphone_2347	"sil @ xx d a jh - r a d sil"	("jh-r") )
( INST_cy_SPKR_diphone_2348	"sil @ xx d a jh - l a d sil"	("jh-l") )
( INST_cy_SPKR_diphone_2349	"sil @ xx d a jh - m a d sil"	("jh-m") )
( INST_cy_SPKR_diphone_2350	"sil @ xx d a jh - n a d sil"	("jh-n") )
( INST_cy_SPKR_diphone_2351	"sil @ xx d a jh - ng a d sil"	("jh-ng") )
( INST_cy_SPKR_diphone_2352	"sil @ xx d a jh - ch a d sil"	("jh-ch") )
( INST_cy_SPKR_diphone_2353	"sil @ xx d a jh - jh a d sil"	("jh-jh") )
( INST_cy_SPKR_diphone_2354	"sil @ xx d a jh - lh a d sil"	("jh-lh") )
( INST_cy_SPKR_diphone_2355	"sil @ xx d a jh - x a d sil"	("jh-x") )
( INST_cy_SPKR_diphone_2356	"sil @ xx d a jh - w a d sil"	("jh-w") )
( INST_cy_SPKR_diphone_2357	"sil @ xx d a jh - j a d sil"	("jh-j") )
( INST_cy_SPKR_diphone_2358	"sil @ xx d a jh - mh a d sil"	("jh-mh") )
( INST_cy_SPKR_diphone_2359	"sil @ xx d a jh - nh a d sil"	("jh-nh") )
( INST_cy_SPKR_diphone_2360	"sil @ xx d a jh - ngh a d sil"	("jh-ngh") )
( INST_cy_SPKR_diphone_2361	"sil @ xx d a jh - lw a d sil"	("jh-lw") )
( INST_cy_SPKR_diphone_2362	"sil @ xx d a jh - nw a d sil"	("jh-nw") )
( INST_cy_SPKR_diphone_2363	"sil @ xx d a jh - rw a d sil"	("jh-rw") )
( INST_cy_SPKR_diphone_2364	"sil @ xx d a jh - rh a d sil"	("jh-rh") )
( INST_cy_SPKR_diphone_2365	"sil @ xx d a jh - hh a d sil"	("jh-hh") )
( INST_cy_SPKR_diphone_2366	"sil @ xx d a jh - z a d sil"	("jh-z") )
( INST_cy_SPKR_diphone_2367	"sil @ xx d a lh - p a d sil"	("lh-p") )
( INST_cy_SPKR_diphone_2368	"sil @ xx d a lh - t a d sil"	("lh-t") )
( INST_cy_SPKR_diphone_2369	"sil @ xx d a lh - k a d sil"	("lh-k") )
( INST_cy_SPKR_diphone_2370	"sil @ xx d a lh - b a d sil"	("lh-b") )
( INST_cy_SPKR_diphone_2371	"sil @ xx d a lh - d a d sil"	("lh-d") )
( INST_cy_SPKR_diphone_2372	"sil @ xx d a lh - g a d sil"	("lh-g") )
( INST_cy_SPKR_diphone_2373	"sil @ xx d a lh - f a d sil"	("lh-f") )
( INST_cy_SPKR_diphone_2374	"sil @ xx d a lh - v a d sil"	("lh-v") )
( INST_cy_SPKR_diphone_2375	"sil @ xx d a lh - th a d sil"	("lh-th") )
( INST_cy_SPKR_diphone_2376	"sil @ xx d a lh - dh a d sil"	("lh-dh") )
( INST_cy_SPKR_diphone_2377	"sil @ xx d a lh - s a d sil"	("lh-s") )
( INST_cy_SPKR_diphone_2378	"sil @ xx d a lh - sh a d sil"	("lh-sh") )
( INST_cy_SPKR_diphone_2379	"sil @ xx d a lh - r a d sil"	("lh-r") )
( INST_cy_SPKR_diphone_2380	"sil @ xx d a lh - l a d sil"	("lh-l") )
( INST_cy_SPKR_diphone_2381	"sil @ xx d a lh - m a d sil"	("lh-m") )
( INST_cy_SPKR_diphone_2382	"sil @ xx d a lh - n a d sil"	("lh-n") )
( INST_cy_SPKR_diphone_2383	"sil @ xx d a lh - ng a d sil"	("lh-ng") )
( INST_cy_SPKR_diphone_2384	"sil @ xx d a lh - ch a d sil"	("lh-ch") )
( INST_cy_SPKR_diphone_2385	"sil @ xx d a lh - jh a d sil"	("lh-jh") )
( INST_cy_SPKR_diphone_2386	"sil @ xx d a lh - lh a d sil"	("lh-lh") )
( INST_cy_SPKR_diphone_2387	"sil @ xx d a lh - x a d sil"	("lh-x") )
( INST_cy_SPKR_diphone_2388	"sil @ xx d a lh - w a d sil"	("lh-w") )
( INST_cy_SPKR_diphone_2389	"sil @ xx d a lh - j a d sil"	("lh-j") )
( INST_cy_SPKR_diphone_2390	"sil @ xx d a lh - mh a d sil"	("lh-mh") )
( INST_cy_SPKR_diphone_2391	"sil @ xx d a lh - nh a d sil"	("lh-nh") )
( INST_cy_SPKR_diphone_2392	"sil @ xx d a lh - ngh a d sil"	("lh-ngh") )
( INST_cy_SPKR_diphone_2393	"sil @ xx d a lh - lw a d sil"	("lh-lw") )
( INST_cy_SPKR_diphone_2394	"sil @ xx d a lh - nw a d sil"	("lh-nw") )
( INST_cy_SPKR_diphone_2395	"sil @ xx d a lh - rw a d sil"	("lh-rw") )
( INST_cy_SPKR_diphone_2396	"sil @ xx d a lh - rh a d sil"	("lh-rh") )
( INST_cy_SPKR_diphone_2397	"sil @ xx d a lh - hh a d sil"	("lh-hh") )
( INST_cy_SPKR_diphone_2398	"sil @ xx d a lh - z a d sil"	("lh-z") )
( INST_cy_SPKR_diphone_2399	"sil @ xx d a x - p a d sil"	("x-p") )
( INST_cy_SPKR_diphone_2400	"sil @ xx d a x - t a d sil"	("x-t") )
( INST_cy_SPKR_diphone_2401	"sil @ xx d a x - k a d sil"	("x-k") )
( INST_cy_SPKR_diphone_2402	"sil @ xx d a x - b a d sil"	("x-b") )
( INST_cy_SPKR_diphone_2403	"sil @ xx d a x - d a d sil"	("x-d") )
( INST_cy_SPKR_diphone_2404	"sil @ xx d a x - g a d sil"	("x-g") )
( INST_cy_SPKR_diphone_2405	"sil @ xx d a x - f a d sil"	("x-f") )
( INST_cy_SPKR_diphone_2406	"sil @ xx d a x - v a d sil"	("x-v") )
( INST_cy_SPKR_diphone_2407	"sil @ xx d a x - th a d sil"	("x-th") )
( INST_cy_SPKR_diphone_2408	"sil @ xx d a x - dh a d sil"	("x-dh") )
( INST_cy_SPKR_diphone_2409	"sil @ xx d a x - s a d sil"	("x-s") )
( INST_cy_SPKR_diphone_2410	"sil @ xx d a x - sh a d sil"	("x-sh") )
( INST_cy_SPKR_diphone_2411	"sil @ xx d a x - r a d sil"	("x-r") )
( INST_cy_SPKR_diphone_2412	"sil @ xx d a x - l a d sil"	("x-l") )
( INST_cy_SPKR_diphone_2413	"sil @ xx d a x - m a d sil"	("x-m") )
( INST_cy_SPKR_diphone_2414	"sil @ xx d a x - n a d sil"	("x-n") )
( INST_cy_SPKR_diphone_2415	"sil @ xx d a x - ng a d sil"	("x-ng") )
( INST_cy_SPKR_diphone_2416	"sil @ xx d a x - ch a d sil"	("x-ch") )
( INST_cy_SPKR_diphone_2417	"sil @ xx d a x - jh a d sil"	("x-jh") )
( INST_cy_SPKR_diphone_2418	"sil @ xx d a x - lh a d sil"	("x-lh") )
( INST_cy_SPKR_diphone_2419	"sil @ xx d a x - x a d sil"	("x-x") )
( INST_cy_SPKR_diphone_2420	"sil @ xx d a x - w a d sil"	("x-w") )
( INST_cy_SPKR_diphone_2421	"sil @ xx d a x - j a d sil"	("x-j") )
( INST_cy_SPKR_diphone_2422	"sil @ xx d a x - mh a d sil"	("x-mh") )
( INST_cy_SPKR_diphone_2423	"sil @ xx d a x - nh a d sil"	("x-nh") )
( INST_cy_SPKR_diphone_2424	"sil @ xx d a x - ngh a d sil"	("x-ngh") )
( INST_cy_SPKR_diphone_2425	"sil @ xx d a x - lw a d sil"	("x-lw") )
( INST_cy_SPKR_diphone_2426	"sil @ xx d a x - nw a d sil"	("x-nw") )
( INST_cy_SPKR_diphone_2427	"sil @ xx d a x - rw a d sil"	("x-rw") )
( INST_cy_SPKR_diphone_2428	"sil @ xx d a x - rh a d sil"	("x-rh") )
( INST_cy_SPKR_diphone_2429	"sil @ xx d a x - hh a d sil"	("x-hh") )
( INST_cy_SPKR_diphone_2430	"sil @ xx d a x - z a d sil"	("x-z") )
( INST_cy_SPKR_diphone_2431	"sil @ xx d a z - p a d sil"	("z-p") )
( INST_cy_SPKR_diphone_2432	"sil @ xx d a z - t a d sil"	("z-t") )
( INST_cy_SPKR_diphone_2433	"sil @ xx d a z - k a d sil"	("z-k") )
( INST_cy_SPKR_diphone_2434	"sil @ xx d a z - b a d sil"	("z-b") )
( INST_cy_SPKR_diphone_2435	"sil @ xx d a z - d a d sil"	("z-d") )
( INST_cy_SPKR_diphone_2436	"sil @ xx d a z - g a d sil"	("z-g") )
( INST_cy_SPKR_diphone_2437	"sil @ xx d a z - f a d sil"	("z-f") )
( INST_cy_SPKR_diphone_2438	"sil @ xx d a z - v a d sil"	("z-v") )
( INST_cy_SPKR_diphone_2439	"sil @ xx d a z - th a d sil"	("z-th") )
( INST_cy_SPKR_diphone_2440	"sil @ xx d a z - dh a d sil"	("z-dh") )
( INST_cy_SPKR_diphone_2441	"sil @ xx d a z - s a d sil"	("z-s") )
( INST_cy_SPKR_diphone_2442	"sil @ xx d a z - sh a d sil"	("z-sh") )
( INST_cy_SPKR_diphone_2443	"sil @ xx d a z - r a d sil"	("z-r") )
( INST_cy_SPKR_diphone_2444	"sil @ xx d a z - l a d sil"	("z-l") )
( INST_cy_SPKR_diphone_2445	"sil @ xx d a z - m a d sil"	("z-m") )
( INST_cy_SPKR_diphone_2446	"sil @ xx d a z - n a d sil"	("z-n") )
( INST_cy_SPKR_diphone_2447	"sil @ xx d a z - ng a d sil"	("z-ng") )
( INST_cy_SPKR_diphone_2448	"sil @ xx d a z - ch a d sil"	("z-ch") )
( INST_cy_SPKR_diphone_2449	"sil @ xx d a z - jh a d sil"	("z-jh") )
( INST_cy_SPKR_diphone_2450	"sil @ xx d a z - lh a d sil"	("z-lh") )
( INST_cy_SPKR_diphone_2451	"sil @ xx d a z - x a d sil"	("z-x") )
( INST_cy_SPKR_diphone_2452	"sil @ xx d a z - w a d sil"	("z-w") )
( INST_cy_SPKR_diphone_2453	"sil @ xx d a z - j a d sil"	("z-j") )
( INST_cy_SPKR_diphone_2454	"sil @ xx d a z - mh a d sil"	("z-mh") )
( INST_cy_SPKR_diphone_2455	"sil @ xx d a z - nh a d sil"	("z-nh") )
( INST_cy_SPKR_diphone_2456	"sil @ xx d a z - ngh a d sil"	("z-ngh") )
( INST_cy_SPKR_diphone_2457	"sil @ xx d a z - lw a d sil"	("z-lw") )
( INST_cy_SPKR_diphone_2458	"sil @ xx d a z - nw a d sil"	("z-nw") )
( INST_cy_SPKR_diphone_2459	"sil @ xx d a z - rw a d sil"	("z-rw") )
( INST_cy_SPKR_diphone_2460	"sil @ xx d a z - rh a d sil"	("z-rh") )
( INST_cy_SPKR_diphone_2461	"sil @ xx d a z - hh a d sil"	("z-hh") )
( INST_cy_SPKR_diphone_2462	"sil @ xx d a z - z a d sil"	("z-z") )
( INST_cy_SPKR_diphone_2463	"sil @ xx t aa - p l aa t ay sil"	("p_-_l") )
( INST_cy_SPKR_diphone_2464	"sil @ xx t aa - t l aa t ay sil"	("t_-_l") )
( INST_cy_SPKR_diphone_2465	"sil @ xx t aa - k l aa t ay sil"	("k_-_l") )
( INST_cy_SPKR_diphone_2466	"sil @ xx t aa - b l aa t ay sil"	("b_-_l") )
( INST_cy_SPKR_diphone_2467	"sil @ xx t aa - d l aa t ay sil"	("d_-_l") )
( INST_cy_SPKR_diphone_2468	"sil @ xx t aa - g l aa t ay sil"	("g_-_l") )
( INST_cy_SPKR_diphone_2469	"sil @ xx t aa - p r aa t ay sil"	("p_-_r") )
( INST_cy_SPKR_diphone_2470	"sil @ xx t aa - t r aa t ay sil"	("t_-_r") )
( INST_cy_SPKR_diphone_2471	"sil @ xx t aa - k r aa t ay sil"	("k_-_r") )
( INST_cy_SPKR_diphone_2472	"sil @ xx t aa - b r aa t ay sil"	("b_-_r") )
( INST_cy_SPKR_diphone_2473	"sil @ xx t aa - d r aa t ay sil"	("d_-_r") )
( INST_cy_SPKR_diphone_2474	"sil @ xx t aa - g r aa t ay sil"	("g_-_r") )
( INST_cy_SPKR_diphone_2475	"sil @ xx d a - p w a d sil"	("p_-_w") )
( INST_cy_SPKR_diphone_2476	"sil @ xx t aa - t w aa t ay sil"	("t_-_w") )
( INST_cy_SPKR_diphone_2477	"sil @ xx t aa - k w aa t ay sil"	("k_-_w") )
( INST_cy_SPKR_diphone_2478	"sil @ xx t aa - b w aa t ay sil"	("b_-_w") )
( INST_cy_SPKR_diphone_2479	"sil @ xx t aa - d w aa t ay sil"	("d_-_w") )
( INST_cy_SPKR_diphone_2480	"sil @ xx t aa - g w aa t ay sil"	("g_-_w") )
( INST_cy_SPKR_diphone_2481	"sil @ xx t aa - s p aa t ay sil"	("s_-_p") )
( INST_cy_SPKR_diphone_2482	"sil @ xx t aa - s t aa t ay sil"	("s_-_t") )
( INST_cy_SPKR_diphone_2483	"sil @ xx t aa - s k aa t ay sil"	("s_-_k") )
( INST_cy_SPKR_diphone_2484	"sil @ xx t aa - s l aa t ay sil"	("s_-_l") )
( INST_cy_SPKR_diphone_2485	"sil @ xx t aa - s w aa t ay sil"	("s_-_w") )
( INST_cy_SPKR_diphone_2486	"sil @ xx t aa - s n aa t ay sil"	("s_-_n") )
( INST_cy_SPKR_diphone_2487	"sil @ xx t aa - s m aa t ay sil"	("s_-_m") )
( INST_cy_SPKR_diphone_2488	"sil @ xx t aa - f l aa t ay sil"	("f_-_l") )
( INST_cy_SPKR_diphone_2489	"sil @ xx t aa - f r aa t ay sil"	("f_-_r") )
( INST_cy_SPKR_diphone_2490	"sil i d ay sil"	("sil-i") )
( INST_cy_SPKR_diphone_2491	"sil e d ay sil"	("sil-e") )
( INST_cy_SPKR_diphone_2492	"sil a d ay sil"	("sil-a") )
( INST_cy_SPKR_diphone_2493	"sil o d ay sil"	("sil-o") )
( INST_cy_SPKR_diphone_2494	"sil u d ay sil"	("sil-u") )
( INST_cy_SPKR_diphone_2495	"sil y d ay sil"	("sil-y") )
( INST_cy_SPKR_diphone_2496	"sil @ d ay sil"	("sil-@") )
( INST_cy_SPKR_diphone_2497	"sil ii d ay sil"	("sil-ii") )
( INST_cy_SPKR_diphone_2498	"sil ee d ay sil"	("sil-ee") )
( INST_cy_SPKR_diphone_2499	"sil aa d ay sil"	("sil-aa") )
( INST_cy_SPKR_diphone_2500	"sil oo d ay sil"	("sil-oo") )
( INST_cy_SPKR_diphone_2501	"sil uu d ay sil"	("sil-uu") )
( INST_cy_SPKR_diphone_2502	"sil yy d ay sil"	("sil-yy") )
( INST_cy_SPKR_diphone_2503	"sil ei d ay sil"	("sil-ei") )
( INST_cy_SPKR_diphone_2504	"sil ai d ay sil"	("sil-ai") )
( INST_cy_SPKR_diphone_2505	"sil oi d ay sil"	("sil-oi") )
( INST_cy_SPKR_diphone_2506	"sil iu d ay sil"	("sil-iu") )
( INST_cy_SPKR_diphone_2507	"sil eu d ay sil"	("sil-eu") )
( INST_cy_SPKR_diphone_2508	"sil au d ay sil"	("sil-au") )
( INST_cy_SPKR_diphone_2509	"sil ou d ay sil"	("sil-ou") )
( INST_cy_SPKR_diphone_2510	"sil uy d ay sil"	("sil-uy") )
( INST_cy_SPKR_diphone_2511	"sil yu d ay sil"	("sil-yu") )
( INST_cy_SPKR_diphone_2512	"sil ay d ay sil"	("sil-ay") )
( INST_cy_SPKR_diphone_2513	"sil aay d ay sil"	("sil-aay") )
( INST_cy_SPKR_diphone_2514	"sil ey d ay sil"	("sil-ey") )
( INST_cy_SPKR_diphone_2515	"sil oy d ay sil"	("sil-oy") )
( INST_cy_SPKR_diphone_2516	"sil p a d ay sil"	("sil-p") )
( INST_cy_SPKR_diphone_2517	"sil t a d ay sil"	("sil-t") )
( INST_cy_SPKR_diphone_2518	"sil k a d ay sil"	("sil-k") )
( INST_cy_SPKR_diphone_2519	"sil b a d ay sil"	("sil-b") )
( INST_cy_SPKR_diphone_2520	"sil d a d ay sil"	("sil-d") )
( INST_cy_SPKR_diphone_2521	"sil g a d ay sil"	("sil-g") )
( INST_cy_SPKR_diphone_2522	"sil f a d ay sil"	("sil-f") )
( INST_cy_SPKR_diphone_2523	"sil v a d ay sil"	("sil-v") )
( INST_cy_SPKR_diphone_2524	"sil th a d ay sil"	("sil-th") )
( INST_cy_SPKR_diphone_2525	"sil dh a d ay sil"	("sil-dh") )
( INST_cy_SPKR_diphone_2526	"sil s a d ay sil"	("sil-s") )
( INST_cy_SPKR_diphone_2527	"sil sh a d ay sil"	("sil-sh") )
( INST_cy_SPKR_diphone_2528	"sil r a d ay sil"	("sil-r") )
( INST_cy_SPKR_diphone_2529	"sil l a d ay sil"	("sil-l") )
( INST_cy_SPKR_diphone_2530	"sil m a d ay sil"	("sil-m") )
( INST_cy_SPKR_diphone_2531	"sil n a d ay sil"	("sil-n") )
( INST_cy_SPKR_diphone_2532	"sil ng a d ay sil"	("sil-ng") )
( INST_cy_SPKR_diphone_2533	"sil ch a d ay sil"	("sil-ch") )
( INST_cy_SPKR_diphone_2534	"sil jh a d ay sil"	("sil-jh") )
( INST_cy_SPKR_diphone_2535	"sil lh a d ay sil"	("sil-lh") )
( INST_cy_SPKR_diphone_2536	"sil x a d ay sil"	("sil-x") )
( INST_cy_SPKR_diphone_2537	"sil w a d ay sil"	("sil-w") )
( INST_cy_SPKR_diphone_2538	"sil j a d ay sil"	("sil-j") )
( INST_cy_SPKR_diphone_2539	"sil mh a d ay sil"	("sil-mh") )
( INST_cy_SPKR_diphone_2540	"sil nh a d ay sil"	("sil-nh") )
( INST_cy_SPKR_diphone_2541	"sil ngh a d ay sil"	("sil-ngh") )
( INST_cy_SPKR_diphone_2542	"sil lw a d ay sil"	("sil-lw") )
( INST_cy_SPKR_diphone_2543	"sil nw a d ay sil"	("sil-nw") )
( INST_cy_SPKR_diphone_2544	"sil rw a d ay sil"	("sil-rw") )
( INST_cy_SPKR_diphone_2545	"sil rh a d ay sil"	("sil-rh") )
( INST_cy_SPKR_diphone_2546	"sil hh a d ay sil"	("sil-hh") )
( INST_cy_SPKR_diphone_2547	"sil z a d ay sil"	("sil-z") )
( INST_cy_SPKR_diphone_2548	"sil @ xx t a p sil"	("p-sil") )
( INST_cy_SPKR_diphone_2549	"sil @ xx t a t sil"	("t-sil") )
( INST_cy_SPKR_diphone_2550	"sil @ xx t a k sil"	("k-sil") )
( INST_cy_SPKR_diphone_2551	"sil @ xx t a b sil"	("b-sil") )
( INST_cy_SPKR_diphone_2552	"sil @ xx t a d sil"	("d-sil") )
( INST_cy_SPKR_diphone_2553	"sil @ xx t a g sil"	("g-sil") )
( INST_cy_SPKR_diphone_2554	"sil @ xx t a f sil"	("f-sil") )
( INST_cy_SPKR_diphone_2555	"sil @ xx t a v sil"	("v-sil") )
( INST_cy_SPKR_diphone_2556	"sil @ xx t a th sil"	("th-sil") )
( INST_cy_SPKR_diphone_2557	"sil @ xx t a dh sil"	("dh-sil") )
( INST_cy_SPKR_diphone_2558	"sil @ xx t a s sil"	("s-sil") )
( INST_cy_SPKR_diphone_2559	"sil @ xx t a sh sil"	("sh-sil") )
( INST_cy_SPKR_diphone_2560	"sil @ xx t a r sil"	("r-sil") )
( INST_cy_SPKR_diphone_2561	"sil @ xx t a l sil"	("l-sil") )
( INST_cy_SPKR_diphone_2562	"sil @ xx t a m sil"	("m-sil") )
( INST_cy_SPKR_diphone_2563	"sil @ xx t a n sil"	("n-sil") )
( INST_cy_SPKR_diphone_2564	"sil @ xx t a ng sil"	("ng-sil") )
( INST_cy_SPKR_diphone_2565	"sil @ xx t a ch sil"	("ch-sil") )
( INST_cy_SPKR_diphone_2566	"sil @ xx t a jh sil"	("jh-sil") )
( INST_cy_SPKR_diphone_2567	"sil @ xx t a lh sil"	("lh-sil") )
( INST_cy_SPKR_diphone_2568	"sil @ xx t a x sil"	("x-sil") )
( INST_cy_SPKR_diphone_2569	"sil @ xx t a z sil"	("z-sil") )
( INST_cy_SPKR_diphone_2570	"sil @ xx t a d i sil"	("i-sil") )
( INST_cy_SPKR_diphone_2571	"sil @ xx t a d e sil"	("e-sil") )
( INST_cy_SPKR_diphone_2572	"sil @ xx t a d a sil"	("a-sil") )
( INST_cy_SPKR_diphone_2573	"sil @ xx t a d o sil"	("o-sil") )
( INST_cy_SPKR_diphone_2574	"sil @ xx t a d u sil"	("u-sil") )
( INST_cy_SPKR_diphone_2575	"sil @ xx t a d y sil"	("y-sil") )
( INST_cy_SPKR_diphone_2576	"sil @ xx t a d @ sil"	("@-sil") )
( INST_cy_SPKR_diphone_2577	"sil @ xx t a d ii sil"	("ii-sil") )
( INST_cy_SPKR_diphone_2578	"sil @ xx t a d ee sil"	("ee-sil") )
( INST_cy_SPKR_diphone_2579	"sil @ xx t a d aa sil"	("aa-sil") )
( INST_cy_SPKR_diphone_2580	"sil @ xx t a d oo sil"	("oo-sil") )
( INST_cy_SPKR_diphone_2581	"sil @ xx t a d uu sil"	("uu-sil") )
( INST_cy_SPKR_diphone_2582	"sil @ xx t a d yy sil"	("yy-sil") )
( INST_cy_SPKR_diphone_2583	"sil @ xx t a d ei sil"	("ei-sil") )
( INST_cy_SPKR_diphone_2584	"sil @ xx t a d ai sil"	("ai-sil") )
( INST_cy_SPKR_diphone_2585	"sil @ xx t a d oi sil"	("oi-sil") )
( INST_cy_SPKR_diphone_2586	"sil @ xx t a d iu sil"	("iu-sil") )
( INST_cy_SPKR_diphone_2587	"sil @ xx t a d eu sil"	("eu-sil") )
( INST_cy_SPKR_diphone_2588	"sil @ xx t a d au sil"	("au-sil") )
( INST_cy_SPKR_diphone_2589	"sil @ xx t a d ou sil"	("ou-sil") )
( INST_cy_SPKR_diphone_2590	"sil @ xx t a d uy sil"	("uy-sil") )
( INST_cy_SPKR_diphone_2591	"sil @ xx t a d yu sil"	("yu-sil") )
( INST_cy_SPKR_diphone_2592	"sil @ xx t a d ay sil"	("ay-sil") )
( INST_cy_SPKR_diphone_2593	"sil @ xx t a d aay sil"	("aay-sil") )
( INST_cy_SPKR_diphone_2594	"sil @ xx t a d ey sil"	("ey-sil") )
( INST_cy_SPKR_diphone_2595	"sil @ xx t a d oy sil"	("oy-sil") )
( INST_cy_SPKR_diphone_2596	"sil t aa t aa sil sil"	("sil-sil") )
( INST_cy_SPKR_diphone_2597	"sil d a zh ii d sil"	("zh-ii") )
( INST_cy_SPKR_diphone_2598	"sil d a zh ee d sil"	("zh-ee") )
( INST_cy_SPKR_diphone_2599	"sil d a zh aa d sil"	("zh-aa") )
( INST_cy_SPKR_diphone_2600	"sil d a zh oo d sil"	("zh-oo") )
( INST_cy_SPKR_diphone_2601	"sil d a zh uu d sil"	("zh-uu") )
( INST_cy_SPKR_diphone_2602	"sil d a zh yy d sil"	("zh-yy") )
( INST_cy_SPKR_diphone_2603	"sil d a zh oi d sil"	("zh-oi") )
( INST_cy_SPKR_diphone_2604	"sil d a zh ai d sil"	("zh-ai") )
( INST_cy_SPKR_diphone_2605	"sil d a zh uy d sil"	("zh-uy") )
( INST_cy_SPKR_diphone_2606	"sil d a zh iu d sil"	("zh-iu") )
( INST_cy_SPKR_diphone_2607	"sil d a zh eu d sil"	("zh-eu") )
( INST_cy_SPKR_diphone_2608	"sil d a zh au d sil"	("zh-au") )
( INST_cy_SPKR_diphone_2609	"sil d a zh ei d sil"	("zh-ei") )
( INST_cy_SPKR_diphone_2610	"sil d a zh ou d sil"	("zh-ou") )
( INST_cy_SPKR_diphone_2611	"sil d a zh yu d sil"	("zh-yu") )
( INST_cy_SPKR_diphone_2612	"sil d a zh ay d sil"	("zh-ay") )
( INST_cy_SPKR_diphone_2613	"sil d a zh ey d sil"	("zh-ey") )
( INST_cy_SPKR_diphone_2614	"sil d a zh oy d sil"	("zh-oy") )
( INST_cy_SPKR_diphone_2615	"sil d a zh aay d sil"	("zh-aay") )
( INST_cy_SPKR_diphone_2616	"sil d @ d i zh i t sil"	("i-zh" "zh-i") )
( INST_cy_SPKR_diphone_2617	"sil d @ d e zh e t sil"	("e-zh" "zh-e") )
( INST_cy_SPKR_diphone_2618	"sil d @ d a zh a t sil"	("a-zh" "zh-a") )
( INST_cy_SPKR_diphone_2619	"sil d @ d o zh o t sil"	("o-zh" "zh-o") )
( INST_cy_SPKR_diphone_2620	"sil d @ d u zh u t sil"	("u-zh" "zh-u") )
( INST_cy_SPKR_diphone_2621	"sil d @ d y zh y t sil"	("y-zh" "zh-y") )
( INST_cy_SPKR_diphone_2622	"sil d @ zh @ d i sil"	("@-zh" "zh-@") )
( INST_cy_SPKR_diphone_2623	"sil d ii zh a d sil"	("ii-zh") )
( INST_cy_SPKR_diphone_2624	"sil d ee zh a d sil"	("ee-zh") )
( INST_cy_SPKR_diphone_2625	"sil d aa zh a d sil"	("aa-zh") )
( INST_cy_SPKR_diphone_2626	"sil d oo zh a d sil"	("oo-zh") )
( INST_cy_SPKR_diphone_2627	"sil d uu zh a d sil"	("uu-zh") )
( INST_cy_SPKR_diphone_2628	"sil d yy zh a d sil"	("yy-zh") )
( INST_cy_SPKR_diphone_2629	"sil d oi zh a d sil"	("oi-zh") )
( INST_cy_SPKR_diphone_2630	"sil d ai zh a d sil"	("ai-zh") )
( INST_cy_SPKR_diphone_2631	"sil d uy zh a d sil"	("uy-zh") )
( INST_cy_SPKR_diphone_2632	"sil d iu zh a d sil"	("iu-zh") )
( INST_cy_SPKR_diphone_2633	"sil d eu zh a d sil"	("eu-zh") )
( INST_cy_SPKR_diphone_2634	"sil d au zh a d sil"	("au-zh") )
( INST_cy_SPKR_diphone_2635	"sil d ei zh a d sil"	("ei-zh") )
( INST_cy_SPKR_diphone_2636	"sil d ou zh a d sil"	("ou-zh") )
( INST_cy_SPKR_diphone_2637	"sil d yu zh a d sil"	("yu-zh") )
( INST_cy_SPKR_diphone_2638	"sil d ay zh a d sil"	("ay-zh") )
( INST_cy_SPKR_diphone_2639	"sil d ey zh a d sil"	("ey-zh") )
( INST_cy_SPKR_diphone_2640	"sil d oy zh a d sil"	("oy-zh") )
( INST_cy_SPKR_diphone_2641	"sil d aay zh a d sil"	("aay-zh") )
( INST_cy_SPKR_diphone_2642	"sil d a r zh a d sil"	("r-zh") )
( INST_cy_SPKR_diphone_2643	"sil dh @ d oa x aa d sil"	("oa-x") )
( INST_cy_SPKR_diphone_2644	"sil dh @ d oa lh aa d sil"	("oa-lh") )
( INST_cy_SPKR_diphone_2645	"sil dh @ d oa rh aa d sil"	("oa-rh") )
( INST_cy_SPKR_diphone_2646	"sil dh @ d oa ng aa d sil"	("oa-ng") )
( INST_cy_SPKR_diphone_2647	"sil dh @ d oa mh aa d sil"	("oa-mh") )
( INST_cy_SPKR_diphone_2648	"sil dh @ d oa nh aa d sil"	("oa-nh") )
( INST_cy_SPKR_diphone_2649	"sil dh @ d oa ngh aa d sil"	("oa-ngh") )
( INST_cy_SPKR_diphone_2650	"sil dh @ d oa lw aa d sil"	("oa-lw") )
( INST_cy_SPKR_diphone_2651	"sil dh @ d oa nw aa d sil"	("oa-nw") )
( INST_cy_SPKR_diphone_2652	"sil dh @ d oa rw aa d sil"	("oa-rw") )
( INST_cy_SPKR_diphone_2653	"sil dh @ d @@ x aa d sil"	("@@-x") )
( INST_cy_SPKR_diphone_2654	"sil dh @ d @@ lh aa d sil"	("@@-lh") )
( INST_cy_SPKR_diphone_2655	"sil dh @ d @@ rh aa d sil"	("@@-rh") )
( INST_cy_SPKR_diphone_2656	"sil dh @ d @@ ng aa d sil"	("@@-ng") )
( INST_cy_SPKR_diphone_2657	"sil dh @ d @@ mh aa d sil"	("@@-mh") )
( INST_cy_SPKR_diphone_2658	"sil dh @ d @@ nh aa d sil"	("@@-nh") )
( INST_cy_SPKR_diphone_2659	"sil dh @ d @@ ngh aa d sil"	("@@-ngh") )
( INST_cy_SPKR_diphone_2660	"sil dh @ d @@ lw aa d sil"	("@@-lw") )
( INST_cy_SPKR_diphone_2661	"sil dh @ d @@ nw aa d sil"	("@@-nw") )
( INST_cy_SPKR_diphone_2662	"sil dh @ d @@ rw aa d sil"	("@@-rw") )
( INST_cy_SPKR_diphone_2663	"sil d @ d i oa d i sil"	("i-oa") )
( INST_cy_SPKR_diphone_2664	"sil d @ d e oa d i sil"	("e-oa") )
( INST_cy_SPKR_diphone_2665	"sil d @ d a oa d i sil"	("a-oa") )
( INST_cy_SPKR_diphone_2666	"sil d @ d o oa d i sil"	("o-oa") )
( INST_cy_SPKR_diphone_2667	"sil d @ d u oa d i sil"	("u-oa") )
( INST_cy_SPKR_diphone_2668	"sil d @ d y oa d i sil"	("y-oa") )
( INST_cy_SPKR_diphone_2669	"sil d @ oa d i sil"	("@-oa") )
( INST_cy_SPKR_diphone_2670	"sil d ii oa d i sil"	("ii-oa") )
( INST_cy_SPKR_diphone_2671	"sil d ee oa d i sil"	("ee-oa") )
( INST_cy_SPKR_diphone_2672	"sil d aa oa d i sil"	("aa-oa" "oa-d") )
( INST_cy_SPKR_diphone_2673	"sil d oo oa d i sil"	("oo-oa") )
( INST_cy_SPKR_diphone_2674	"sil d uu oa d i sil"	("uu-oa") )
( INST_cy_SPKR_diphone_2675	"sil d yy oa d i sil"	("yy-oa") )
( INST_cy_SPKR_diphone_2676	"sil d oi oa d i sil"	("oi-oa") )
( INST_cy_SPKR_diphone_2677	"sil d ai oa d i sil"	("ai-oa") )
( INST_cy_SPKR_diphone_2678	"sil d uy oa d i sil"	("uy-oa") )
( INST_cy_SPKR_diphone_2679	"sil d iu oa d i sil"	("iu-oa") )
( INST_cy_SPKR_diphone_2680	"sil d eu oa d i sil"	("eu-oa") )
( INST_cy_SPKR_diphone_2681	"sil d au oa d i sil"	("au-oa") )
( INST_cy_SPKR_diphone_2682	"sil d ei oa d i sil"	("ei-oa") )
( INST_cy_SPKR_diphone_2683	"sil d ou oa d i sil"	("ou-oa") )
( INST_cy_SPKR_diphone_2684	"sil d yu oa d i sil"	("yu-oa") )
( INST_cy_SPKR_diphone_2685	"sil d ay oa d i sil"	("ay-oa") )
( INST_cy_SPKR_diphone_2686	"sil d ey oa d i sil"	("ey-oa") )
( INST_cy_SPKR_diphone_2687	"sil d oy oa d i sil"	("oy-oa") )
( INST_cy_SPKR_diphone_2688	"sil d aay oa d i sil"	("aay-oa") )
( INST_cy_SPKR_diphone_2689	"sil d @ d i @@ d sil"	("i-@@") )
( INST_cy_SPKR_diphone_2690	"sil d @ d e @@ d sil"	("e-@@") )
( INST_cy_SPKR_diphone_2691	"sil d @ d a @@ d sil"	("a-@@") )
( INST_cy_SPKR_diphone_2692	"sil d @ d o @@ d sil"	("o-@@") )
( INST_cy_SPKR_diphone_2693	"sil d @ d u @@ d sil"	("u-@@") )
( INST_cy_SPKR_diphone_2694	"sil d @ d y @@ d sil"	("y-@@") )
( INST_cy_SPKR_diphone_2695	"sil d @ @@ d sil"	("@-@@") )
( INST_cy_SPKR_diphone_2696	"sil d ii @@ d sil"	("ii-@@") )
( INST_cy_SPKR_diphone_2697	"sil d ee @@ d sil"	("ee-@@") )
( INST_cy_SPKR_diphone_2698	"sil d aa @@ d sil"	("aa-@@" "@@-d") )
( INST_cy_SPKR_diphone_2699	"sil d oo @@ d sil"	("oo-@@") )
( INST_cy_SPKR_diphone_2700	"sil d uu @@ d sil"	("uu-@@") )
( INST_cy_SPKR_diphone_2701	"sil d yy @@ d sil"	("yy-@@") )
( INST_cy_SPKR_diphone_2702	"sil d oi @@ d sil"	("oi-@@") )
( INST_cy_SPKR_diphone_2703	"sil d ai @@ d sil"	("ai-@@") )
( INST_cy_SPKR_diphone_2704	"sil d uy @@ d sil"	("uy-@@") )
( INST_cy_SPKR_diphone_2705	"sil d iu @@ d sil"	("iu-@@") )
( INST_cy_SPKR_diphone_2706	"sil d eu @@ d sil"	("eu-@@") )
( INST_cy_SPKR_diphone_2707	"sil d au @@ d sil"	("au-@@") )
( INST_cy_SPKR_diphone_2708	"sil d ei @@ d sil"	("ei-@@") )
( INST_cy_SPKR_diphone_2709	"sil d ou @@ d sil"	("ou-@@") )
( INST_cy_SPKR_diphone_2710	"sil d yu @@ d sil"	("yu-@@") )
( INST_cy_SPKR_diphone_2711	"sil d ay @@ d sil"	("ay-@@") )
( INST_cy_SPKR_diphone_2712	"sil d ey @@ d sil"	("ey-@@") )
( INST_cy_SPKR_diphone_2713	"sil d oy @@ d sil"	("oy-@@") )
( INST_cy_SPKR_diphone_2714	"sil d aay @@ d sil"	("aay-@@") )
( INST_cy_SPKR_diphone_2715	"sil d oa i t sil"	("oa-i") )
( INST_cy_SPKR_diphone_2716	"sil d oa e t sil"	("oa-e") )
( INST_cy_SPKR_diphone_2717	"sil d oa a t sil"	("oa-a") )
( INST_cy_SPKR_diphone_2718	"sil d oa o t sil"	("oa-o") )
( INST_cy_SPKR_diphone_2719	"sil d oa u t sil"	("oa-u") )
( INST_cy_SPKR_diphone_2720	"sil d oa y t sil"	("oa-y") )
( INST_cy_SPKR_diphone_2721	"sil d oa @ d i sil"	("oa-@") )
( INST_cy_SPKR_diphone_2722	"sil d oa ii d sil"	("oa-ii") )
( INST_cy_SPKR_diphone_2723	"sil d oa ee d sil"	("oa-ee") )
( INST_cy_SPKR_diphone_2724	"sil d oa aa d sil"	("oa-aa" "d-oa") )
( INST_cy_SPKR_diphone_2725	"sil d oa oo d sil"	("oa-oo") )
( INST_cy_SPKR_diphone_2726	"sil d oa uu d sil"	("oa-uu") )
( INST_cy_SPKR_diphone_2727	"sil d oa yy d sil"	("oa-yy") )
( INST_cy_SPKR_diphone_2728	"sil d oa oi d sil"	("oa-oi") )
( INST_cy_SPKR_diphone_2729	"sil d oa ai d sil"	("oa-ai") )
( INST_cy_SPKR_diphone_2730	"sil d oa uy d sil"	("oa-uy") )
( INST_cy_SPKR_diphone_2731	"sil d oa iu d sil"	("oa-iu") )
( INST_cy_SPKR_diphone_2732	"sil d oa eu d sil"	("oa-eu") )
( INST_cy_SPKR_diphone_2733	"sil d oa au d sil"	("oa-au") )
( INST_cy_SPKR_diphone_2734	"sil d oa ei d sil"	("oa-ei") )
( INST_cy_SPKR_diphone_2735	"sil d oa ou d sil"	("oa-ou") )
( INST_cy_SPKR_diphone_2736	"sil d oa yu d sil"	("oa-yu") )
( INST_cy_SPKR_diphone_2737	"sil d oa ay d sil"	("oa-ay") )
( INST_cy_SPKR_diphone_2738	"sil d oa ey d sil"	("oa-ey") )
( INST_cy_SPKR_diphone_2739	"sil d oa oy d sil"	("oa-oy") )
( INST_cy_SPKR_diphone_2740	"sil d oa aay d sil"	("oa-aay") )
( INST_cy_SPKR_diphone_2741	"sil d @@ i t sil"	("@@-i") )
( INST_cy_SPKR_diphone_2742	"sil d @@ e t sil"	("@@-e") )
( INST_cy_SPKR_diphone_2743	"sil d @@ a t sil"	("@@-a") )
( INST_cy_SPKR_diphone_2744	"sil d @@ o t sil"	("@@-o") )
( INST_cy_SPKR_diphone_2745	"sil d @@ u t sil"	("@@-u") )
( INST_cy_SPKR_diphone_2746	"sil d @@ y t sil"	("@@-y") )
( INST_cy_SPKR_diphone_2747	"sil d @@ @ d i sil"	("@@-@") )
( INST_cy_SPKR_diphone_2748	"sil d @@ ii d sil"	("@@-ii") )
( INST_cy_SPKR_diphone_2749	"sil d @@ ee d sil"	("@@-ee") )
( INST_cy_SPKR_diphone_2750	"sil d @@ aa d sil"	("@@-aa" "d-@@") )
( INST_cy_SPKR_diphone_2751	"sil d @@ oo d sil"	("@@-oo") )
( INST_cy_SPKR_diphone_2752	"sil d @@ uu d sil"	("@@-uu") )
( INST_cy_SPKR_diphone_2753	"sil d @@ yy d sil"	("@@-yy") )
( INST_cy_SPKR_diphone_2754	"sil d @@ oi d sil"	("@@-oi") )
( INST_cy_SPKR_diphone_2755	"sil d @@ ai d sil"	("@@-ai") )
( INST_cy_SPKR_diphone_2756	"sil d @@ uy d sil"	("@@-uy") )
( INST_cy_SPKR_diphone_2757	"sil d @@ iu d sil"	("@@-iu") )
( INST_cy_SPKR_diphone_2758	"sil d @@ eu d sil"	("@@-eu") )
( INST_cy_SPKR_diphone_2759	"sil d @@ au d sil"	("@@-au") )
( INST_cy_SPKR_diphone_2760	"sil d @@ ei d sil"	("@@-ei") )
( INST_cy_SPKR_diphone_2761	"sil d @@ ou d sil"	("@@-ou") )
( INST_cy_SPKR_diphone_2762	"sil d @@ yu d sil"	("@@-yu") )
( INST_cy_SPKR_diphone_2763	"sil d @@ ay d sil"	("@@-ay") )
( INST_cy_SPKR_diphone_2764	"sil d @@ ey d sil"	("@@-ey") )
( INST_cy_SPKR_diphone_2765	"sil d @@ oy d sil"	("@@-oy") )
( INST_cy_SPKR_diphone_2766	"sil d @@ aay d sil"	("@@-aay") )
( INST_cy_SPKR_diphone_2767	"sil dh @ d oa x aa d sil"	("oa-x") )
( INST_cy_SPKR_diphone_2768	"sil dh @ d oa lh aa d sil"	("oa-lh") )
( INST_cy_SPKR_diphone_2769	"sil dh @ d @@ x aa d sil"	("@@-x") )
( INST_cy_SPKR_diphone_2770	"sil dh @ d @@ lh aa d sil"	("@@-lh") )
( INST_cy_SPKR_diphone_2771	"sil d aa x zh a d sil"	("x-zh") )
( INST_cy_SPKR_diphone_2772	"sil d aa lh zh a d sil"	("lh-zh") )
( INST_cy_SPKR_diphone_2773	"sil d a zh x aa d sil"	("zh-x") )
( INST_cy_SPKR_diphone_2774	"sil d a zh lh aa d sil"	("zh-lh") )
( INST_cy_SPKR_diphone_2775	"sil d a zh rh aa d sil"	("zh-rh") )
( INST_cy_SPKR_diphone_2776	"sil d a zh mh aa d sil"	("zh-mh") )
( INST_cy_SPKR_diphone_2777	"sil d a zh nh aa d sil"	("zh-nh") )
( INST_cy_SPKR_diphone_2778	"sil d a zh ngh aa d sil"	("zh-ngh") )
( INST_cy_SPKR_diphone_2779	"sil d a zh lw aa d sil"	("zh-lw") )
( INST_cy_SPKR_diphone_2780	"sil d a zh nw aa d sil"	("zh-nw") )
( INST_cy_SPKR_diphone_2781	"sil d a zh rw aa d sil"	("zh-rw") )
( INST_cy_SPKR_diphone_2782	"sil oa d i sil"	("sil-oa") )
( INST_cy_SPKR_diphone_2783	"sil @@ d @ sil"	("sil-@@") )
( INST_cy_SPKR_diphone_2784	"sil @ d oa sil"	("oa-sil") )
( INST_cy_SPKR_diphone_2785	"sil @ d @@ sil"	("@@-sil") )
( INST_cy_SPKR_diphone_2786	"sil dh @ p oa d i sil"	("p-oa") )
( INST_cy_SPKR_diphone_2787	"sil dh @ t oa d i sil"	("t-oa") )
( INST_cy_SPKR_diphone_2788	"sil dh @ k oa d i sil"	("k-oa") )
( INST_cy_SPKR_diphone_2789	"sil dh @ b oa d i sil"	("b-oa") )
( INST_cy_SPKR_diphone_2790	"sil dh @ g oa d i sil"	("g-oa") )
( INST_cy_SPKR_diphone_2791	"sil dh @ f oa d i sil"	("f-oa") )
( INST_cy_SPKR_diphone_2792	"sil dh @ th oa d i sil"	("th-oa") )
( INST_cy_SPKR_diphone_2793	"sil dh @ hh oa d i sil"	("hh-oa") )
( INST_cy_SPKR_diphone_2794	"sil dh @ v oa d i sil"	("v-oa") )
( INST_cy_SPKR_diphone_2795	"sil dh @ dh oa d i sil"	("dh-oa") )
( INST_cy_SPKR_diphone_2796	"sil dh @ s oa d i sil"	("s-oa") )
( INST_cy_SPKR_diphone_2797	"sil dh @ z oa d i sil"	("z-oa") )
( INST_cy_SPKR_diphone_2798	"sil dh @ sh oa d i sil"	("sh-oa") )
( INST_cy_SPKR_diphone_2799	"sil dh @ zh oa d i sil"	("zh-oa") )
( INST_cy_SPKR_diphone_2800	"sil dh @ ch oa d i sil"	("ch-oa") )
( INST_cy_SPKR_diphone_2801	"sil dh @ jh oa d i sil"	("jh-oa") )
( INST_cy_SPKR_diphone_2802	"sil dh @ l oa d i sil"	("l-oa") )
( INST_cy_SPKR_diphone_2803	"sil dh @ r oa d i sil"	("r-oa") )
( INST_cy_SPKR_diphone_2804	"sil dh @ w oa d i sil"	("w-oa") )
( INST_cy_SPKR_diphone_2805	"sil dh @ j oa d i sil"	("j-oa") )
( INST_cy_SPKR_diphone_2806	"sil dh @ m oa d i sil"	("m-oa") )
( INST_cy_SPKR_diphone_2807	"sil dh @ n oa d i sil"	("n-oa") )
( INST_cy_SPKR_diphone_2808	"sil d a ng oa d i sil"	("ng-oa") )
( INST_cy_SPKR_diphone_2809	"sil dh @ p @@ d i sil"	("p-@@") )
( INST_cy_SPKR_diphone_2810	"sil dh @ t @@ d i sil"	("t-@@") )
( INST_cy_SPKR_diphone_2811	"sil dh @ k @@ d i sil"	("k-@@") )
( INST_cy_SPKR_diphone_2812	"sil dh @ b @@ d i sil"	("b-@@") )
( INST_cy_SPKR_diphone_2813	"sil dh @ g @@ d i sil"	("g-@@") )
( INST_cy_SPKR_diphone_2814	"sil dh @ f @@ d i sil"	("f-@@") )
( INST_cy_SPKR_diphone_2815	"sil dh @ th @@ d i sil"	("th-@@") )
( INST_cy_SPKR_diphone_2816	"sil dh @ hh @@ d i sil"	("hh-@@") )
( INST_cy_SPKR_diphone_2817	"sil dh @ v @@ d i sil"	("v-@@") )
( INST_cy_SPKR_diphone_2818	"sil dh @ dh @@ d i sil"	("dh-@@") )
( INST_cy_SPKR_diphone_2819	"sil dh @ s @@ d i sil"	("s-@@") )
( INST_cy_SPKR_diphone_2820	"sil dh @ z @@ d i sil"	("z-@@") )
( INST_cy_SPKR_diphone_2821	"sil dh @ sh @@ d i sil"	("sh-@@") )
( INST_cy_SPKR_diphone_2822	"sil dh @ zh @@ d i sil"	("zh-@@") )
( INST_cy_SPKR_diphone_2823	"sil dh @ ch @@ d i sil"	("ch-@@") )
( INST_cy_SPKR_diphone_2824	"sil dh @ jh @@ d i sil"	("jh-@@") )
( INST_cy_SPKR_diphone_2825	"sil dh @ l @@ d i sil"	("l-@@") )
( INST_cy_SPKR_diphone_2826	"sil dh @ r @@ d i sil"	("r-@@") )
( INST_cy_SPKR_diphone_2827	"sil dh @ w @@ d i sil"	("w-@@") )
( INST_cy_SPKR_diphone_2828	"sil dh @ j @@ d i sil"	("j-@@") )
( INST_cy_SPKR_diphone_2829	"sil dh @ m @@ d i sil"	("m-@@") )
( INST_cy_SPKR_diphone_2830	"sil dh @ n @@ d i sil"	("n-@@") )
( INST_cy_SPKR_diphone_2831	"sil d a ng @@ d i sil"	("ng-@@") )
( INST_cy_SPKR_diphone_2832	"sil dh @ d oa p i d sil"	("oa-p") )
( INST_cy_SPKR_diphone_2833	"sil dh @ d oa t i d sil"	("oa-t") )
( INST_cy_SPKR_diphone_2834	"sil dh @ d oa k i d sil"	("oa-k") )
( INST_cy_SPKR_diphone_2835	"sil dh @ d oa b i d sil"	("oa-b") )
( INST_cy_SPKR_diphone_2836	"sil dh @ d oa g i d sil"	("oa-g") )
( INST_cy_SPKR_diphone_2837	"sil dh @ d oa f i d sil"	("oa-f") )
( INST_cy_SPKR_diphone_2838	"sil dh @ d oa th i d sil"	("oa-th") )
( INST_cy_SPKR_diphone_2839	"sil dh @ d oa hh i d sil"	("oa-hh") )
( INST_cy_SPKR_diphone_2840	"sil dh @ d oa v i d sil"	("oa-v") )
( INST_cy_SPKR_diphone_2841	"sil dh @ d oa dh i d sil"	("oa-dh") )
( INST_cy_SPKR_diphone_2842	"sil dh @ d oa s i d sil"	("oa-s") )
( INST_cy_SPKR_diphone_2843	"sil dh @ d oa z i d sil"	("oa-z") )
( INST_cy_SPKR_diphone_2844	"sil dh @ d oa sh i d sil"	("oa-sh") )
( INST_cy_SPKR_diphone_2845	"sil dh @ d oa zh i d sil"	("oa-zh") )
( INST_cy_SPKR_diphone_2846	"sil dh @ d oa ch i d sil"	("oa-ch") )
( INST_cy_SPKR_diphone_2847	"sil dh @ d oa jh i d sil"	("oa-jh") )
( INST_cy_SPKR_diphone_2848	"sil dh @ d oa l i d sil"	("oa-l") )
( INST_cy_SPKR_diphone_2849	"sil dh @ d oa r i d sil"	("oa-r") )
( INST_cy_SPKR_diphone_2850	"sil dh @ d oa w i d sil"	("oa-w") )
( INST_cy_SPKR_diphone_2851	"sil dh @ d oa j i d sil"	("oa-j") )
( INST_cy_SPKR_diphone_2852	"sil dh @ d oa m i d sil"	("oa-m") )
( INST_cy_SPKR_diphone_2853	"sil dh @ d oa n i d sil"	("oa-n") )
( INST_cy_SPKR_diphone_2854	"sil dh @ d @@ p i d sil"	("@@-p") )
( INST_cy_SPKR_diphone_2855	"sil dh @ d @@ t i d sil"	("@@-t") )
( INST_cy_SPKR_diphone_2856	"sil dh @ d @@ k i d sil"	("@@-k") )
( INST_cy_SPKR_diphone_2857	"sil dh @ d @@ b i d sil"	("@@-b") )
( INST_cy_SPKR_diphone_2858	"sil dh @ d @@ g i d sil"	("@@-g") )
( INST_cy_SPKR_diphone_2859	"sil dh @ d @@ f i d sil"	("@@-f") )
( INST_cy_SPKR_diphone_2860	"sil dh @ d @@ th i d sil"	("@@-th") )
( INST_cy_SPKR_diphone_2861	"sil dh @ d @@ hh i d sil"	("@@-hh") )
( INST_cy_SPKR_diphone_2862	"sil dh @ d @@ v i d sil"	("@@-v") )
( INST_cy_SPKR_diphone_2863	"sil dh @ d @@ dh i d sil"	("@@-dh") )
( INST_cy_SPKR_diphone_2864	"sil dh @ d @@ s i d sil"	("@@-s") )
( INST_cy_SPKR_diphone_2865	"sil dh @ d @@ z i d sil"	("@@-z") )
( INST_cy_SPKR_diphone_2866	"sil dh @ d @@ sh i d sil"	("@@-sh") )
( INST_cy_SPKR_diphone_2867	"sil dh @ d @@ zh i d sil"	("@@-zh") )
( INST_cy_SPKR_diphone_2868	"sil dh @ d @@ ch i d sil"	("@@-ch") )
( INST_cy_SPKR_diphone_2869	"sil dh @ d @@ jh i d sil"	("@@-jh") )
( INST_cy_SPKR_diphone_2870	"sil dh @ d @@ l i d sil"	("@@-l") )
( INST_cy_SPKR_diphone_2871	"sil dh @ d @@ r i d sil"	("@@-r") )
( INST_cy_SPKR_diphone_2872	"sil dh @ d @@ w i d sil"	("@@-w") )
( INST_cy_SPKR_diphone_2873	"sil dh @ d @@ j i d sil"	("@@-j") )
( INST_cy_SPKR_diphone_2874	"sil dh @ d @@ m i d sil"	("@@-m") )
( INST_cy_SPKR_diphone_2875	"sil dh @ d @@ n i d sil"	("@@-n") )
( INST_cy_SPKR_diphone_2876	"sil dh @ d oa p sil"	("oa-p") )
( INST_cy_SPKR_diphone_2877	"sil dh @ d oa t sil"	("oa-t") )
( INST_cy_SPKR_diphone_2878	"sil dh @ d oa k sil"	("oa-k") )
( INST_cy_SPKR_diphone_2879	"sil dh @ d oa b sil"	("oa-b") )
( INST_cy_SPKR_diphone_2880	"sil dh @ d oa g sil"	("oa-g") )
( INST_cy_SPKR_diphone_2881	"sil dh @ d @@ p sil"	("@@-p") )
( INST_cy_SPKR_diphone_2882	"sil dh @ d @@ t sil"	("@@-t") )
( INST_cy_SPKR_diphone_2883	"sil dh @ d @@ k sil"	("@@-k") )
( INST_cy_SPKR_diphone_2884	"sil dh @ d @@ b sil"	("@@-b") )
( INST_cy_SPKR_diphone_2885	"sil dh @ d @@ g sil"	("@@-g") )
( INST_cy_SPKR_diphone_2886	"sil d a p zh a d sil"	("p-zh") )
( INST_cy_SPKR_diphone_2887	"sil d a t zh a d sil"	("t-zh") )
( INST_cy_SPKR_diphone_2888	"sil d a k zh a d sil"	("k-zh") )
( INST_cy_SPKR_diphone_2889	"sil d a b zh a d sil"	("b-zh") )
( INST_cy_SPKR_diphone_2890	"sil d a d zh a d sil"	("d-zh") )
( INST_cy_SPKR_diphone_2891	"sil d a g zh a d sil"	("g-zh") )
( INST_cy_SPKR_diphone_2892	"sil d a f zh a d sil"	("f-zh") )
( INST_cy_SPKR_diphone_2893	"sil d a th zh a d sil"	("th-zh") )
( INST_cy_SPKR_diphone_2894	"sil d a v zh a d sil"	("v-zh") )
( INST_cy_SPKR_diphone_2895	"sil d a dh zh a d sil"	("dh-zh") )
( INST_cy_SPKR_diphone_2896	"sil d a s zh a d sil"	("s-zh") )
( INST_cy_SPKR_diphone_2897	"sil d a z zh a d sil"	("z-zh") )
( INST_cy_SPKR_diphone_2898	"sil d a sh zh a d sil"	("sh-zh") )
( INST_cy_SPKR_diphone_2899	"sil d a zh zh a d sil"	("zh-zh") )
( INST_cy_SPKR_diphone_2900	"sil d a ch zh a d sil"	("ch-zh") )
( INST_cy_SPKR_diphone_2901	"sil d a jh zh a d sil"	("jh-zh") )
( INST_cy_SPKR_diphone_2902	"sil d a l zh a d sil"	("l-zh") )
( INST_cy_SPKR_diphone_2903	"sil d a m zh a d sil"	("m-zh") )
( INST_cy_SPKR_diphone_2904	"sil d a n zh a d sil"	("n-zh") )
( INST_cy_SPKR_diphone_2905	"sil d a ng zh a d sil"	("ng-zh") )
( INST_cy_SPKR_diphone_2906	"sil d a zh p a d sil"	("zh-p") )
( INST_cy_SPKR_diphone_2907	"sil d a zh t a d sil"	("zh-t") )
( INST_cy_SPKR_diphone_2908	"sil d a zh k a d sil"	("zh-k") )
( INST_cy_SPKR_diphone_2909	"sil d a zh b a d sil"	("zh-b") )
( INST_cy_SPKR_diphone_2910	"sil d a zh d a d sil"	("zh-d") )
( INST_cy_SPKR_diphone_2911	"sil d a zh g a d sil"	("zh-g") )
( INST_cy_SPKR_diphone_2912	"sil d a zh f a d sil"	("zh-f") )
( INST_cy_SPKR_diphone_2913	"sil d a zh th a d sil"	("zh-th") )
( INST_cy_SPKR_diphone_2914	"sil d a zh hh a d sil"	("zh-hh") )
( INST_cy_SPKR_diphone_2915	"sil d a zh v a d sil"	("zh-v") )
( INST_cy_SPKR_diphone_2916	"sil d a zh dh a d sil"	("zh-dh") )
( INST_cy_SPKR_diphone_2917	"sil d a zh s a d sil"	("zh-s") )
( INST_cy_SPKR_diphone_2918	"sil d a zh z a d sil"	("zh-z") )
( INST_cy_SPKR_diphone_2919	"sil d a zh sh a d sil"	("zh-sh") )
( INST_cy_SPKR_diphone_2920	"sil d a zh ch a d sil"	("zh-ch") )
( INST_cy_SPKR_diphone_2921	"sil d a zh jh a d sil"	("zh-jh") )
( INST_cy_SPKR_diphone_2922	"sil d a zh l a d sil"	("zh-l") )
( INST_cy_SPKR_diphone_2923	"sil d a zh r a d sil"	("zh-r") )
( INST_cy_SPKR_diphone_2924	"sil d a zh w a d sil"	("zh-w") )
( INST_cy_SPKR_diphone_2925	"sil d a zh j a d sil"	("zh-j") )
( INST_cy_SPKR_diphone_2926	"sil d a zh m a d sil"	("zh-m") )
( INST_cy_SPKR_diphone_2927	"sil d a zh n a d sil"	("zh-n") )
( INST_cy_SPKR_diphone_2928	"sil zh a d sil"	("sil-zh") )
( INST_cy_SPKR_diphone_2929	"sil d a zh sil"	("zh-sil") )
( INST_cy_SPKR_diphone_2930	"sil d oa oa d i sil"	("oa-oa") )
( INST_cy_SPKR_diphone_2931	"sil d @@ oa d i sil"	("@@-oa") )
( INST_cy_SPKR_diphone_2932	"sil d oa @@ d i sil"	("oa-@@") )
( INST_cy_SPKR_diphone_2933	"sil d @@ @@ d i sil"	("@@-@@") )
( INST_cy_SPKR_diphone_2934	"sil @ j i p ii sil"	("j-i") )
( INST_cy_SPKR_diphone_2935	"sil i n s i n j u ee t sil"	("j-u") )
( INST_cy_SPKR_diphone_2936	"sil t u j @ l a n d @ sil"	("j-@") )
( INST_cy_SPKR_diphone_2937	"sil dh @ j ii s t sil"	("j-ii") )
( INST_cy_SPKR_diphone_2938	"sil dh @ j uu s sil"	("j-uu") )
( INST_cy_SPKR_diphone_2939	"sil j oi k s sil"	("j-oi") )
( INST_cy_SPKR_diphone_2940	"sil t @ j ou d @ l sil"	("j-ou") )
